src	target	pred	status
ank	अंक	एंके	pred_false
anka	अंक	अंका	pred_false
ankit	अंकित	अंकित	pred_true
anakon	अंकों	अनकों	pred_false
ankhon	अंकों	अंखों	pred_false
ankon	अंकों	अंकों	pred_true
angkor	अंकोर	अंगकोर	pred_false
ankor	अंकोर	एंकर	pred_false
angaarak	अंगारक	अंगारक	pred_true
angarak	अंगारक	अंगरक	pred_false
angraji	अंग्रज़ी	अंगराजी	pred_false
angreji	अंग्रज़ी	अग्रेजी	pred_false
angrzi	अंग्रज़ी	अग्रजजी	pred_false
antah	अंतः	अंताह	pred_false
antaha	अंतः	अंतहा	pred_false
antarmukh	अंतर्मुख	अंतरमुख	pred_false
antmurkh	अंतर्मुख	अंतमुर्ख	pred_false
antrmukh	अंतर्मुख	अंतर्मख	pred_false
andrabee	अंद्राबी	अंद्रबी	pred_false
andrabi	अंद्राबी	अंद्रबी	pred_false
andha	अंधा	अंधा	pred_true
andhapan	अंधापन	अंधपान	pred_false
andheri	अंधेरी	अंधेरी	pred_true
ambaani	अंबानी	अंबानी	pred_true
ambani	अंबानी	अं्बनी	pred_false
akram	अकरम	आक्रम	pred_false
acapulco	अकापुल्को	अकापुल्को	pred_true
akapulko	अकापुल्को	अकालुक्को	pred_false
akhand	अखंड	अखंड	pred_true
akhil	अखिल	अखिल	pred_true
agavai	अगवाई	अगवाई	pred_true
agvaai	अगवाई	अगवाई	pred_true
augustine	अगस्टाइन	आगस्टिन	pred_false
augustustine	अगस्टाइन	आगस्ट्यूटिन	pred_false
agsta	अगस्ता	अज्सता	pred_false
agusta	अगस्ता	अगस्ता	pred_true
augusta	अगस्ता	अगस्ता	pred_true
agr	अग्र	एगर	pred_false
agra	अग्र	अग्रा	pred_false
achambha	अचंभा	अचंभा	pred_true
achanbha	अचंभा	अचंभा	pred_true
achievement	अचीवमेंट	अक्वामेंट	pred_false
achivement	अचीवमेंट	अक्विमेंट	pred_false
acchi	अच्छी	अच्ची	pred_false
achchi	अच्छी	अच्ची	pred_false
achhi	अच्छी	अछी	pred_false
achyut	अच्युत	अछूयुट	pred_false
achhanera	अछनेरा	अच्चेरा	pred_false
achnera	अछनेरा	अचनेरा	pred_false
ajmeedh	अजमीढ़	अजमीदध	pred_false
ajhar	अजहर	अजार	pred_false
azhar	अजहर	अहार	pred_false
ajit	अजित	अजीत	pred_false
agnat	अज्ञात	अग्नत	pred_false
agyaat	अज्ञात	अज्ञात	pred_true
agyat	अज्ञात	अज्ञात	pred_true
atakta	अटकता	अतकता	pred_false
atkata	अटकता	अटकता	pred_true
atake	अटके	अटके	pred_true
atke	अटके	अटके	pred_true
atwaal	अटवाल	अटवाल	pred_true
atwal	अटवाल	अटवाल	pred_true
attahasa	अट्टहास	अत्थासा	pred_false
atthaas	अट्टहास	अट्थास	pred_false
atthas	अट्टहास	अट्थास	pred_false
addon	अड्डों	एड्डों	pred_false
athak	अथक	अठक	pred_false
atharv	अथर्व	अथर्व	pred_true
atharva	अथर्व	अठरवा	pred_false
adad	अदद	अदाद	pred_false
adaani	अदाणी	अदानी	pred_false
adani	अदाणी	अदानी	pred_false
advait	अद्वैत	एडवात	pred_false
adwait	अद्वैत	एडवात	pred_false
advaitvaad	अद्वैतवाद	अदववत्वाद	pred_false
advaitwad	अद्वैतवाद	अदववतावाद	pred_false
adhivas	अधिवास	अधिवास	pred_true
adhiwas	अधिवास	अधिवास	pred_true
advivas	अधिवास	एदववास	pred_false
adhiik	अधीक	अधिक	pred_false
adhik	अधीक	अधिक	pred_false
adhyayanarat	अध्ययनरत	अध्ययनर्त	pred_false
adhyayanrat	अध्ययनरत	अध्ययनर्त	pred_false
adhyaynrat	अध्ययनरत	अध्ययनत्रित	pred_false
anant	अनंत	अनांत	pred_false
ananti	अनंती	अनांती	pred_false
angadh	अनगढ़	अंगध	pred_false
angarh	अनगढ़	अंगरह	pred_false
anchahe	अनचाहे	अंचहे	pred_false
anthak	अनथक	अंथक	pred_false
unthak	अनथक	ऊंथक	pred_false
anhoni	अनहोनी	अन्होनी	pred_false
anaavashyak	अनावश्यक	अनावाष्यक	pred_false
anavashyak	अनावश्यक	अनावा्यक	pred_false
anavshyak	अनावश्यक	अनावश्यक	pred_true
anawashyak	अनावश्यक	अनावायक्षक	pred_false
anik	अनिक	अनिक	pred_true
anishwarvadi	अनीश्वरवादी	अनिश्वर्वादी	pred_false
anishwarwadi	अनीश्वरवादी	अनिश्वरावी	pred_false
anukoltha	अनुकूलता	अनुकोलता	pred_false
anukulata	अनुकूलता	अनुकुलता	pred_false
anukulta	अनुकूलता	अनुकुलता	pred_false
anuchit	अनुचित	अनुचित	pred_true
anuprayogi	अनुप्रयोगों	अनुपर्योगी	pred_false
anuprayogon	अनुप्रयोगों	अनुपर्गों	pred_false
anupryogon	अनुप्रयोगों	अनुपर्गों	pred_false
anureet	अनुरीत	अनुरीत	pred_true
anurit	अनुरीत	अनुरित	pred_false
anuthi	अनूठी	अनुठी	pred_false
anudit	अनूदित	अनुदित	pred_false
anyaay	अन्याय	अन्याय	pred_true
anyay	अन्याय	अन्याय	pred_true
anyaya	अन्याय	अन्यया	pred_false
apnani	अपनानी	अपनानी	pred_true
aparivartanshali	अपरिवर्तनशील	अपरिवर्तनशीली	pred_false
aparivartansheel	अपरिवर्तनशील	अपरिवर्तनशील	pred_true
aparivartanshil	अपरिवर्तनशील	अपरिवर्तनशील	pred_true
apariharya	अपरिहार्य	अपरियर्य	pred_false
aprihary	अपरिहार्य	अपरियार्य	pred_false
apriyary	अपरिहार्य	अप्रियररी	pred_false
apavartit	अपवर्तित	अपवार्तित	pred_false
apvartit	अपवर्तित	अपवर्तीत	pred_false
apvtrit	अपवर्तित	अपव्त्रित	pred_false
apaardarshi	अपारदर्शी	अपरादर्शी	pred_false
apardarshi	अपारदर्शी	अपरदर्शी	pred_false
afroj	अफरोज	अफ्रोज	pred_false
afroz	अफरोज	अफ्रोज	pred_false
africa	अफ्रीका	अफ्रिका	pred_false
abbaasi	अब्बासी	अब्बासी	pred_true
abbasi	अब्बासी	अब्बासी	pred_true
abhimat	अभिमत	अभिमात	pred_false
abhishap	अभिशाप	अभिशप	pred_false
abhi	अभी	अभी	pred_true
amjhera	अमझेरा	अमझेरा	pred_true
amzera	अमझेरा	अम्जेरा	pred_false
amargad	अमरगढ़	अमरगढ़	pred_true
amargarh	अमरगढ़	अमरगढ़	pred_true
amarpaal	अमरपाल	अमरपाल	pred_true
amarpal	अमरपाल	अमरपाल	pred_true
amarohi	अमरोही	अमरोही	pred_true
amrohi	अमरोही	अमरोही	pred_true
amaanat	अमानत	अमानत	pred_true
amanat	अमानत	अमानत	pred_true
amanth	अमानत	अमांत	pred_false
amaanati	अमानती	अमानती	pred_true
amanathi	अमानती	अमानाथी	pred_false
amanati	अमानती	अमानती	pred_true
amavasya	अमावस्या	अमावस्य	pred_false
amavsya	अमावस्या	अमावस्य	pred_false
amit	अमित	एमिट	pred_false
amitao	अमिताव	अमिताओ	pred_false
amitav	अमिताव	अमितव	pred_false
amuk	अमुक	अमुक	pred_true
amogh	अमोघ	अमोग	pred_false
ambani	अम्बानी	अं्बनी	pred_false
ayodhyaanaath	अयोध्यानाथ	अयोध्यनाथ	pred_false
ayodhyanaath	अयोध्यानाथ	अयोध्यनाथ	pred_false
ayodhyanath	अयोध्यानाथ	अयोध्यनाथ	pred_false
ayodhyeanath	अयोध्यानाथ	अयोध्यनाथ	pred_false
aradas	अरदास	अरादास	pred_false
ardaas	अरदास	अर्दास	pred_false
ardas	अरदास	अर्दास	pred_false
arabab	अरबाब	अरबब	pred_false
arbab	अरबाब	अरबब	pred_false
around	अराउंड	आराउंड	pred_false
arjent	अर्जेंट	अर्जेंट	pred_true
urgent	अर्जेंट	यर्जेंट	pred_false
arth	अर्थ	आर्थ	pred_false
artha	अर्थ	आर्थ	pred_false
earth	अर्थ	इर्थ	pred_false
earthquake	अर्थक्वेक	इर्थकलेक	pred_false
arthon	अर्थों	आर्थों	pred_false
arpit	अर्पित	आर्टिट	pred_false
aryama	अर्यमा	आर्यमा	pred_false
aryma	अर्यमा	आर्यमा	pred_false
arymaa	अर्यमा	आर्यमा	pred_false
alankaar	अलंकार	अलंकार	pred_true
alankar	अलंकार	अलंकर	pred_false
alnkaar	अलंकार	अलंकार	pred_true
alankaaron	अलंकारों	अलंकारों	pred_true
alankaron	अलंकारों	अलंकारों	pred_true
alnkaaron	अलंकारों	अलकारों	pred_false
alnkaron	अलंकारों	अलकररों	pred_false
alagavavadi	अलगाववादी	अलगवावादी	pred_false
algavvadi	अलगाववादी	अलगवावादी	pred_false
algavwaadi	अलगाववादी	अल्गवाडी	pred_false
alive	अलाइव	एलीव	pred_false
alance	अलायंस	एलेंस	pred_false
alayans	अलायंस	अलयांस	pred_false
aliance	अलायंस	एलायंस	pred_false
alind	अलिंद	एलिंड	pred_false
alai	अली	अलाई	pred_false
ali	अली	एली	pred_false
alii	अली	एली	pred_false
alonso	अलोंसो	एलोंस	pred_false
aloso	अलोंसो	आलोसो	pred_false
alphabet	अल्फ़ाबेट	अल्फाबेट	pred_false
alba	अल्बा	अल्बा	pred_true
avantipur	अवंतिपुर	अवंतीपुर	pred_false
awantipora	अवंतिपुर	अवंतीपोर	pred_false
avaru	अवरु	अवरु	pred_true
avru	अवरु	अवरू	pred_false
awaru	अवरु	अवरू	pred_false
avarodhak	अवरोधक	अवरोधक	pred_true
avrodhak	अवरोधक	अवरोधक	pred_true
avrodhk	अवरोधक	अवरोधक	pred_true
avarnata	अवर्णता	अवर्णता	pred_true
avarnataa	अवर्णता	अवर्णता	pred_true
avranta	अवर्णता	अवरंता	pred_false
avashist	अवशिष्ट	अवशिष्ट	pred_true
avshisht	अवशिष्ट	अवशिष्ट	pred_true
awashist	अवशिष्ट	अवशिष्ट	pred_true
avasthaayen	अवस्थाएं	अवस्थाएं	pred_true
avsthaen	अवस्थाएं	अवस्थाएं	pred_true
avsthayen	अवस्थाएं	अवस्थाएं	pred_true
awasthaen	अवस्थाएं	अवस्थाएं	pred_true
avi	अवि	एवी	pred_false
avika	अविका	अविका	pred_true
aviral	अविरल	अविराल	pred_false
avirl	अविरल	एवर्ल	pred_false
avishvaasniy	अविश्वसनीय	अविश्वानीय	pred_false
avishvasniy	अविश्वसनीय	अविश्वानीय	pred_false
avishvasniya	अविश्वसनीय	अविश्वासीय	pred_false
avisvasniya	अविश्वसनीय	अविस्वासीय	pred_false
aviva	अवीवा	अविवा	pred_false
avaigyanic	अवैज्ञानिक	अवैज्यानिक	pred_false
avaigyanik	अवैज्ञानिक	अवैज्ञानिक	pred_true
avegyanik	अवैज्ञानिक	अवेज्ञानिक	pred_false
ashaktataa	अशक्तता	अशक्तता	pred_true
ashktta	अशक्तता	अश्क्तता	pred_false
asharaphi	अशरफी	अशारपाही	pred_false
ashrafi	अशरफी	अश्राफी	pred_false
ashariri	अशरीरी	आशारीरी	pred_false
ashriri	अशरीरी	अश्रीरी	pred_false
ashrvatath	अश्वत्थ	अश्वर्थाथ	pred_false
ashvtth	अश्वत्थ	अश्वत्थ	pred_true
asamaany	असमान्य	असमान्य	pred_true
asamany	असमान्य	असामान्य	pred_false
asmanye	असमान्य	असमान्य	pred_true
asaamnjsy	असामंजस्य	असामंजी	pred_false
asamanjasy	असामंजस्य	असमाजज्य	pred_false
asamanjasya	असामंजस्य	असमाजज्य	pred_false
asurakshit	असुरक्षित	असुरक्षित	pred_true
asurkshit	असुरक्षित	असुरक्षित	pred_true
aset	असेट	एसेट	pred_false
asset	असेट	एसेट	pred_false
asvabhavik	अस्वभाविक	अस्वाभाविक	pred_false
aswabhavik	अस्वभाविक	अस्वाभाविक	pred_false
aswbhavik	अस्वभाविक	अस्भाविक	pred_false
ahirauli	अहिरौली	अहिरौली	pred_true
item	आइटम	इतेम	pred_false
items	आइटम्स	इटेम्स	pred_false
idle	आइडल	आइडल	pred_true
idol	आइडल	आईडोल	pred_false
icc	आइसीसी	आईसीसी	pred_false
iso	आइसो	इसो	pred_false
ipc	आईपीसी	आईईीीी	pred_false
ipad	आईपैड	आईपड़	pred_false
iris	आईरिस	आइरिस	pred_false
ounce	आउंस	आंस	pred_false
aakaash	आकाश	आकाश	pred_true
aakash	आकाश	आकाश	pred_true
aake	आके	आके	pred_true
aakhet	आखेट	आखेत	pred_false
akhet	आखेट	अखेत	pred_false
aagat	आगत	आगत	pred_true
aagaman	आगमन	आगमन	pred_true
aagman	आगमन	आगमान	pred_false
aagaa	आग़ा	आगा	pred_false
aagah	आग़ा	आगाह	pred_false
agha	आग़ा	आघा	pred_false
aagaashe	आगाशे	आगाशे	pred_true
aagashe	आगाशे	आगशशे	pred_false
agashe	आगाशे	अग्शे	pred_false
aajmaanaa	आजमाना	आजमाना	pred_true
aajmana	आजमाना	आजमाना	pred_true
aazmaanaa	आजमाना	आजमाना	pred_true
aata	आटा	आता	pred_false
ata	आटा	एटा	pred_false
atta	आटा	अट्टा	pred_false
aatmayen	आत्माएं	आत्माएं	pred_true
atmaen	आत्माएं	आत्माएं	pred_true
aadaan	आदान	आदान	pred_true
aadan	आदान	आदन	pred_false
aadhaarit	आधारित	आधारित	pred_true
aadharit	आधारित	आधारित	pred_true
adharit	आधारित	अधारित	pred_false
aadheen	आधीन	आधीन	pred_true
aadhin	आधीन	आधीन	pred_true
aadhunik	आधुनिक	आधुनिक	pred_true
aanad	आनद	आनाद	pred_false
aanand	आनद	आनंद	pred_false
anand	आनद	अनंद	pred_false
aapka	आपका	आपका	pred_true
aapkaa	आपका	आपका	pred_true
aapadaaaen	आपदाएं	आपदाएं	pred_true
aapdaein	आपदाएं	आपदाएं	pred_true
aapdayein	आपदाएं	आपदाएं	pred_true
aabantit	आबंटित	आबंंतित	pred_false
abantit	आबंटित	आबंंतित	pred_false
aabru	आबरू	आब्रू	pred_false
abaru	आबरू	अबारू	pred_false
aamdan	आमदन	आमदान	pred_false
amadan	आमदन	अमादन	pred_false
aamdani	आमदनी	आम्ानी	pred_false
amadani	आमदनी	अमाानी	pred_false
aamdi	आमदी	आमदी	pred_true
amdi	आमदी	एमडी	pred_false
aamod	आमोद	आमोद	pred_true
amod	आमोद	अमोद	pred_false
aayenge	आयेंगे	आयेंगे	pred_true
aayojak	आयोजक	आयोजक	pred_true
ro	आरओ	रो	pred_false
rp	आरपी	आरपी	pred_true
aaraam	आराम	आराम	pred_true
aaram	आराम	आराम	pred_true
aram	आराम	आराम	pred_true
aarushi	आरुषि	आरुशी	pred_false
arushi	आरुषि	अरुशी	pred_false
artery	आर्टरी	आर्टरी	pred_true
order	आर्डर	आर्डर	pred_true
aary	आर्य	आर्य	pred_true
aarya	आर्य	आर्य	pred_true
arya	आर्य	आर्य	pred_true
aaryika	आर्यिका	आर्यिका	pred_true
aryika	आर्यिका	आर्यिका	pred_true
aarya	आर्यो	आर्य	pred_false
arya	आर्यो	आर्य	pred_false
aryo	आर्यो	आर्यो	pred_true
aaryan	आर्यों	आर्यन	pred_false
arya	आर्यों	आर्य	pred_false
aryon	आर्यों	आर्यों	pred_true
aalsi	आलसी	आलसी	pred_true
alasi	आलसी	अलसी	pred_false
aalochak	आलोचक	आलोचक	pred_true
alochak	आलोचक	आलोचक	pred_true
aalochakon	आलोचकों	आलोचकों	pred_true
alochakon	आलोचकों	आलोचकों	pred_true
aalha	आल्हा	आल्हा	pred_true
aalhaa	आल्हा	आल्हा	pred_true
alha	आल्हा	अल्हा	pred_false
allah	आल्हा	अल्लाह	pred_false
aawaazen	आवाज़ें	आवाजें	pred_false
aawajen	आवाज़ें	आवाजें	pred_false
awaazen	आवाज़ें	आवाजें	pred_false
awazen	आवाज़ें	अवाजें	pred_false
aawajon	आवाज़ों	आवाजों	pred_false
aawazon	आवाज़ों	आवाजों	pred_false
awaazon	आवाज़ों	आवाजों	pred_false
awazon	आवाज़ों	आवाजों	pred_false
aavishakaar	आविष्कार	आविषाकार	pred_false
aavishkaar	आविष्कार	आविष्कार	pred_true
avishkar	आविष्कार	अविष्कार	pred_false
aavriti	आवृत्ति	आवृति	pred_false
aavritti	आवृत्ति	आवृत्ति	pred_true
avuti	आवृत्ति	अवूटी	pred_false
aavritiyon	आवृत्तियों	आवृतियों	pred_false
aavrittiyon	आवृत्तियों	आवृत्तियों	pred_true
avrutiyon	आवृत्तियों	आवृतियों	pred_false
aashanka	आशंका	आशंका	pred_true
ashanka	आशंका	अशंका	pred_false
aashriton	आश्रितों	आश्रितों	pred_true
ashriton	आश्रितों	अश्रितों	pred_false
aasaan	आसान	आसान	pred_true
aasan	आसान	आसन	pred_false
asan	आसान	असन	pred_false
aastik	आस्तिक	आस्तिक	pred_true
astik	आस्तिक	अस्तिक	pred_false
aasteen	आस्तीन	आस्तीन	pred_true
aastin	आस्तीन	आस्तीन	pred_true
astin	आस्तीन	एस्टिन	pred_false
aahnaan	आह्नान	आहनान	pred_false
aahnan	आह्नान	आहनन	pred_false
ahyan	आह्नान	आह्वान	pred_false
england	इंग्लैंड	इंग्लैंड	pred_true
engineer	इंजिनियर	इंजीनियर	pred_false
introduction	इंट्रोडक्शन	इंट्रोड्क्शन	pred_false
insurance	इंश्योरेंस	इनससरेंस	pred_false
ear	इअर	इयर	pred_false
eyer	इअर	आइयर	pred_false
eon	इआन	इयों	pred_false
iaan	इआन	आईएन	pred_false
ekattha	इकट्ठा	एक्त्ठा	pred_false
ikattha	इकट्ठा	इकठ्ठा	pred_false
ekatthi	इकठ्ठी	एक्त्ठी	pred_false
ekthi	इकठ्ठी	एक्टी	pred_false
ikatthi	इकठ्ठी	इकट्ठी	pred_false
ekaee	इकाई	एकाई	pred_false
ikai	इकाई	इकाई	pred_true
ekaeyon	इकाईयों	एकाइयों	pred_false
ikaiyon	इकाईयों	इकाइयों	pred_false
ikarion	इकाईयों	इकारियन	pred_false
economic	इकोनोमिक	इकोनोमिक	pred_true
ecuador	इक्वाडोर	इक्यूडर	pred_false
equador	इक्वाडोर	इकुवाडर	pred_false
equities	इक्विटीज	एक्वीटिज	pred_false
ikvitija	इक्विटीज	इक्विजिता	pred_false
ijaajat	इजाजत	इजाजात	pred_false
ijajat	इजाजत	इज़ाजत	pred_false
inhalation	इनहेलेशन	इन्हालशेशन	pred_false
inhaletion	इनहेलेशन	इन्हेलेशन	pred_false
ibija	इबीजा	इबीजा	pred_true
ibiza	इबीजा	इबिज़ा	pred_false
imaging	इमेजिंग	इमैजिंग	pred_false
immune	इम्युन	इम्यून	pred_false
elaichi	इलाइची	इलेकि	pred_false
ilaichi	इलाइची	इलाचि	pred_false
ilayachi	इलाइची	इलायची	pred_false
ilayichi	इलाइची	इलायिची	pred_false
elaaj	इलाज	एलाज	pred_false
ilaaj	इलाज	इलाज	pred_true
ilaj	इलाज	इलाज	pred_true
ishaak	इशाक	इशाक	pred_true
ishaaq	इशाक	इशाक	pred_true
ishak	इशाक	इशक	pred_false
ishaara	इशारा	इशारा	pred_true
ishaaraa	इशारा	इशारा	pred_true
ishara	इशारा	इशारा	pred_true
ishita	इशिता	इशिता	pred_true
isht	इष्ट	इष्ट	pred_true
isteefe	इस्तीफे	इस्टीफे	pred_false
istife	इस्तीफे	इस्टीफाइ	pred_false
ea	ईए	इए	pred_false
ia	ईए	इए	pred_false
eater	ईटर	इटर	pred_false
iter	ईटर	इटर	pred_false
email	ईमेल	एमैल	pred_false
emailon	ईमेलों	एमाइलों	pred_false
emelon	ईमेलों	एमेलों	pred_false
evening	ईवनिंग	इवेनिंग	pred_false
east	ईष्ट	ईस्ट	pred_false
ishat	ईष्ट	इषात	pred_false
isht	ईष्ट	इष्ट	pred_false
isaaiyon	ईसाइयों	इसाइयों	pred_false
isaiyon	ईसाइयों	ईसाइयों	pred_true
isayiyon	ईसाइयों	इसाईयों	pred_false
ikhrul	उखरुल	इखृल	pred_false
ukhrool	उखरुल	उखरूल	pred_false
ukhrul	उखरुल	उखरूल	pred_false
uchhalane	उछालने	उछलने	pred_false
uchhalne	उछालने	उछलने	pred_false
ujback	उज़्बेक	जज्बेक	pred_false
uzbek	उज़्बेक	उजबेक	pred_false
uthane	उठने	उठाने	pred_false
uthne	उठने	उठने	pred_true
uthaakar	उठाकर	उठाकर	pred_true
uthakar	उठाकर	उठकर	pred_false
uthaapatak	उठापटक	उठापतक	pred_false
uthapatak	उठापटक	उठापतक	pred_false
uthen	उठें	उठें	pred_true
udaan	उड़ान	उड़न	pred_false
udan	उड़ान	उड़न	pred_false
udaanaa	उड़ाना	उड़ना	pred_false
udana	उड़ाना	उड़ना	pred_false
udaane	उड़ाने	उड़ने	pred_false
udane	उड़ाने	उड़ने	pred_false
udaanen	उड़ानें	उड़नें	pred_false
udanen	उड़ानें	उड़नें	pred_false
udaanon	उड़ानों	उड़नों	pred_false
udanon	उड़ानों	उड़नों	pred_false
utane	उतने	उतने	pred_true
utaney	उतने	उतने	pred_true
utne	उतने	उतने	pred_true
uttara	उत्तरा	उतरता	pred_false
uttra	उत्तरा	उत्त्र	pred_false
utpan	उत्पन	उत्पान	pred_false
udant	उदंत	उडांत	pred_false
udghosh	उदघोष	उद्घोष	pred_false
udar	उदर	उदार	pred_false
uda	उदा	उड़ा	pred_false
udaa	उदा	उड़ा	pred_false
udakishuganj	उदाकिशुनगंज	उदाकिशंज	pred_false
udakishunganj	उदाकिशुनगंज	उदाकिशंज	pred_false
unatees	उनतीस	यूनातीस	pred_false
untees	उनतीस	ऊंतीस	pred_false
uniyal	उनियाल	यूनियाल	pred_false
upadraviyon	उपद्रवियों	उपद्रवियों	pred_true
updravion	उपद्रवियों	उप्रदववियों	pred_false
updraviyon	उपद्रवियों	उपद्रवियों	pred_true
upadravi	उपद्रवी	उपद्रवी	pred_true
updravi	उपद्रवी	उपद्रवी	pred_true
upadrawon	उपद्रवों	उपद्रावों	pred_false
updravon	उपद्रवों	उपद्रावों	pred_false
upneta	उपनेता	उपनेता	pred_true
upabhokta	उपभोक्ता	उपभोकता	pred_false
upbhokta	उपभोक्ता	उपभोकता	pred_false
uplaksh	उपलक्ष्य	उपल्कश	pred_false
uplakshay	उपलक्ष्य	उपल्क्षय	pred_false
uplakshya	उपलक्ष्य	उपल्ष्य	pred_false
uplabdh	उपलब्ध	उपलब्ध	pred_true
uplabdhiyon	उपलब्धियों	उपलब्धियों	pred_true
uplabdhi	उपलब्धी	उपलब्धी	pred_true
upakhyaanon	उपाख्यानों	उपख्यानों	pred_false
upakhyanon	उपाख्यानों	उपख्यानों	pred_false
ubuntu	उबंटू	उबुंतु	pred_false
ubaal	उबाल	उबाल	pred_true
ubal	उबाल	उबल	pred_false
ubhaara	उभारा	उभरा	pred_false
ubhara	उभारा	उभरा	pred_false
umanath	उमानाथ	उमानाथ	pred_true
umesh	उमेश	उमेश	pred_true
urf	उर्फ	यूफर	pred_false
urfa	उर्फ	उफरा	pred_false
urff	उर्फ	आफफफफ	pred_false
urvarakon	उर्वरकों	उर्वारकों	pred_false
urvarkon	उर्वरकों	उर्वरकों	pred_true
urwarakon	उर्वरकों	उर्वारकों	pred_false
urvarata	उर्वरता	उरवारता	pred_false
urvarta	उर्वरता	उरवर्ता	pred_false
urwarta	उर्वरता	उरवारता	pred_false
ulate	उलटे	उलाते	pred_false
ulte	उलटे	अल्टे	pred_false
ulahana	उलाहना	उलाहना	pred_true
ulahna	उलाहना	उलाहना	pred_true
ulema	उलेमा	उल्मे	pred_false
ulemaon	उलेमाओं	उल्मेआलओं	pred_false
usak	उसक	उसक	pred_true
usaki	उसकी	उसकी	pred_true
uski	उसकी	उसकी	pred_true
usmein	उसमें	उसमें	pred_true
usmen	उसमें	उसमें	pred_true
usi	उसी	यूसी	pred_false
ustara	उस्तरा	उस्तरा	pred_true
udharv	ऊर्ध्व	उधररव	pred_false
udhrva	ऊर्ध्व	उद्रवा	pred_false
urdhav	ऊर्ध्व	उर्धव	pred_false
ushma	ऊष्मा	उष्म	pred_false
rishicool	ऋषिकुल	ऋिशूकल	pred_false
rishikul	ऋषिकुल	ऋषिकुल	pred_true
rushikul	ऋषिकुल	ऋषिकूल	pred_false
enzyme	एंजाइम	एंजीम	pred_false
anton	एंटोन	एंटन	pred_false
entone	एंटोन	इंटोन	pred_false
antoni	एंटोनी	एंटोनी	pred_true
antony	एंटोनी	एंटोनी	pred_true
endometrial	एंडोमेट्रियल	एंडोमेमेट्रियल	pred_false
andreas	एंड्रियास	एंड्रेज	pred_false
als	एएलएस	अल्स	pred_false
asi	एएसआई	एसी	pred_false
eksaath	एकसाथ	एकसाथ	pred_true
eksath	एकसाथ	एकसाथ	pred_true
ekaki	एकाकी	एकाी	pred_false
xm	एक्सएम	एक्समम	pred_false
egmor	एगमोर	एगममर	pred_false
egmore	एगमोर	एगमोर	pred_true
aj	एजे	एज	pred_false
agende	एजेंडे	एजेंडे	pred_true
adp	एडीपी	एडपी	pred_false
adain	एडेन	अडादन	pred_false
aden	एडेन	एडेन	pred_true
edan	एडेन	एडान	pred_false
addi	एड्डी	एडी	pred_false
eddi	एड्डी	एड्डी	pred_true
eddie	एड्डी	एडीडी	pred_false
eddy	एड्डी	एडीडी	pred_false
apj	एपीजे	अपज	pred_false
ftii	एफटीआईआई	फफ्टी	pred_false
abbott	एबट	अब्बोट	pred_false
abut	एबट	अब्ट	pred_false
ebt	एबट	इबीटी	pred_false
abvp	एबीवीपी	अबपीपी	pred_false
abbot	एबोट	अब्बोट	pred_false
abbott	एबोट	अब्बोट	pred_false
mta	एमटीए	एमटीए	pred_true
mtake	एमटेक	मटके	pred_false
mtec	एमटेक	एमटेस	pred_false
mtech	एमटेक	एमटेक	pred_true
emerald	एमरल्ड	एमरर्ल	pred_false
emrald	एमरल्ड	एमराल्ड	pred_false
emil	एमिल	एमिल	pred_true
emile	एमिल	एमिले	pred_false
emily	एमिल	एमिली	pred_false
amy	एमी	एमी	pred_true
emi	एमी	एमी	pred_true
airway	एयरवे	एयरवाय	pred_false
eyarave	एयरवे	एयरवे	pred_true
eyarve	एयरवे	एयरवे	pred_true
error	एरर	एरर	pred_true
arica	एरिका	एरिका	pred_true
erica	एरिका	एरिका	pred_true
erika	एरिका	एरिका	pred_true
aerobic	एरोबिक	एयोबिक	pred_false
aerobics	एरोबिक	एयोबिक्स	pred_false
lte	एलटीई	एलए	pred_false
lti	एलटीई	लीटी	pred_false
allergic	एलर्जिक	एल्र्जिक	pred_false
eliminator	एलिमिनेटर	एलिमाइंटर	pred_false
aliens	एलियंस	एलायंस	pred_false
alliance	एलियंस	एलायंस	pred_false
asian	एशियन	एशियां	pred_false
sfc	एसएफसी	एससीसी	pred_false
sk	एसके	एससी	pred_false
spf	एसपीएफ	एसएफी	pred_false
association	एसोसिएशन	एसोसिएशन	pred_true
astar	एस्टर	अस्तर	pred_false
aster	एस्टर	एस्टर	pred_true
ester	एस्टर	एस्टर	pred_true
aesthetics	एस्थेटिक	एस्टेटेक्स	pred_false
asthetic	एस्थेटिक	अस्थेटिक	pred_false
asfalt	एस्फाल्ट	असफलत	pred_false
asphalt	एस्फाल्ट	अस्पललत	pred_false
asphault	एस्फाल्ट	अस्फुलेट	pred_false
ahsaas	एहसास	अहसास	pred_false
ehsaas	एहसास	एहसास	pred_true
ehsas	एहसास	एहसास	pred_true
aisa	एेसा	एसा	pred_false
eesa	एेसा	इजा	pred_false
ainth	ऐंठ	ऐंठ	pred_true
end	ऐंठ	एंड	pred_false
enth	ऐंठ	एंठ	pred_false
ainthey	ऐंठे	ऐंठे	pred_true
enthe	ऐंठे	ऐंठे	pred_true
aithan	ऐठन	ऐंठन	pred_false
ethan	ऐठन	ऐंठन	pred_false
ethhan	ऐठन	एंठन	pred_false
ail	ऐल	एल	pred_false
el	ऐल	एल	pred_false
alaps	ऐल्प्स	अलप्स	pred_false
alps	ऐल्प्स	अल्प्स	pred_false
aise	ऐसे	एसे	pred_false
oxide	ऑक्साइड	ऑक्सीड	pred_false
oxy	ऑक्सी	ऑक्सी	pred_true
offers	ऑफर्स	आफर्स	pred_false
offshor	ऑफशोर	आफशेशर	pred_false
offshore	ऑफशोर	आफ्शेयर	pred_false
official	ऑफिशियल	आफिशियल	pred_false
okalahoma	ओकलाहोमा	ओकोलहा	pred_false
oklahoma	ओकलाहोमा	ओक्लोहामा	pred_false
oklahoma	ओक्लाहोमा	ओक्लोहामा	pred_false
ot	ओत	ओटी	pred_false
opel	ओपेल	ओपेल	pred_true
obrayan	ओब्रायन	ओबरायन	pred_false
obrien	ओब्रायन	ओब्रिएन	pred_false
oran	ओरण	ओरान	pred_false
orian	ओरियन	ओरियन	pred_true
orion	ओरियन	ओरियन	pred_true
olavrishti	ओलावृष्टि	ओलावृष्टि	pred_true
ovum	ओवम	ओवम	pred_true
owem	ओवम	ओवेम	pred_false
oceanic	ओशनिक	ओकेनिक	pred_false
osaka	ओसाका	ओसका	pred_false
auchity	औचित्य	ऑकिटी	pred_false
auchitya	औचित्य	अछित्य	pred_false
audhyogikaran	औद्योगिकरण	औध्योगीकरण	pred_false
audyogikarana	औद्योगिकरण	औदोगिकरण	pred_false
audyogikikaran	औद्योगिकरण	औदोगिकरण	pred_false
aurangabad	औरंगाबाद	औरंगाबाद	pred_true
aurora	औरोरा	औरोरा	pred_true
aulakh	औलख	औलखख	pred_false
kankad	कंकड़	कंकड़	pred_true
kankar	कंकड़	कंकर	pred_false
kankad	कंकर	कंकड़	pred_false
kankar	कंकर	कंकर	pred_true
kangan	कंगन	कागन	pred_false
conjunction	कंजंक्शन	कंंकुसेशन	pred_false
contemporary	कंटेम्पररी	कॉंटमेररी	pred_false
kanthahar	कंठहार	कंठहर	pred_false
kanthhar	कंठहार	कंठार	pred_false
composer	कंपोजर	कॉंपोर	pred_false
kambalon	कंबलों	कांबलों	pred_false
kanblon	कंबलों	कांबलों	pred_false
consultant	कंसलटेंट	कंसल्टंंट	pred_false
kakkad	कक्कड़	कक्कड़	pred_true
kakkar	कक्कड़	कक्कर	pred_false
kacche	कच्चे	कच्चे	pred_true
kachche	कच्चे	कच्छे	pred_false
karta	कटरा	कररता	pred_false
katra	कटरा	कटर	pred_false
cutlery	कटलरी	कटलरी	pred_true
katlari	कटलरी	कत्लरी	pred_false
katlary	कटलरी	कत्लरे	pred_false
katasaraj	कटासराज	कत्सराज	pred_false
kathfodave	कठफोड़वे	कथोड़ेव	pred_false
kathfodve	कठफोड़वे	काठोड़वेे	pred_false
kathor	कठोर	कथोर	pred_false
kathore	कठोर	कथोर	pred_false
kanika	कणिका	कानिका	pred_false
kathai	कत्थई	कथाई	pred_false
katthai	कत्थई	कट्ठाई	pred_false
katthaii	कत्थई	कट्ठाई	pred_false
convention	कनवेंशन	कॉनवेशन	pred_false
canals	कनाल	कैनल्स	pred_false
kanaal	कनाल	कनाल	pred_true
kanal	कनाल	कनाल	pred_true
kanindham	कनिंघम	कणिंधम	pred_false
kaningham	कनिंघम	कानिघम	pred_false
kanishthika	कनिष्ठिका	कनिष्ठिका	pred_true
kanishthikaa	कनिष्ठिका	कनिष्ठिका	pred_true
kanishtika	कनिष्ठिका	कनिष्टिका	pred_false
kanyaayen	कन्याएं	कन्याएं	pred_true
kanyaein	कन्याएं	कन्याएं	pred_true
kanyayen	कन्याएं	कन्याएं	pred_true
convention	कन्वेंशन	कॉनवेशन	pred_false
convocation	कन्वोकेशन	कन्वोक्शन	pred_false
cup	कप	कीप	pred_false
kap	कप	कप	pred_true
kapda	कपड़ा	कपड़ा	pred_true
kpada	कपड़ा	कपाड़ा	pred_false
kapdo	कपड़ो	कपड़ो	pred_true
kapdon	कपड़ो	कपड़ों	pred_false
kaping	कपिंग	कापिंग	pred_false
kping	कपिंग	कपपिंग	pred_false
kapolkalpana	कपोलकल्पना	कपोोकलपपाा	pred_false
kabaddi	कबड्डी	कबबड़ी	pred_false
kabr	कब्र	कब्र	pred_true
kabra	कब्र	कबबरा	pred_false
kabren	कब्रें	कबरें	pred_false
kabron	कब्रों	कबरों	pred_false
kamjor	कमज़ोर	कमजोर	pred_false
kamzor	कमज़ोर	कमजजोर	pred_false
kamatar	कमतर	कमततर	pred_false
kamtar	कमतर	कामतर	pred_false
kalamjeet	कमलजीत	कललजीमत	pred_false
kamaljeet	कमलजीत	कमलजीत	pred_true
kamaauu	कमाऊ	कमाओ	pred_false
kamau	कमाऊ	कमाओ	pred_false
kamaate	कमाते	कमाते	pred_true
kamate	कमाते	कमते	pred_false
kamere	कमेरे	कमेरे	pred_true
kmere	कमेरे	कमेरे	pred_true
karanj	करंज	करणज	pred_false
kranj	करंज	क्रांज	pred_false
karanjiya	करंजिया	करणजीय	pred_false
kardhe	करघे	कर्धे	pred_false
karghe	करघे	कारेघे	pred_false
karachana	करछना	कराचना	pred_false
karchhana	करछना	कर्चना	pred_false
karna	करना	करना	pred_true
karpatri	करपात्री	करपत्री	pred_false
karam	करम	कराम	pred_false
karoor	करूर	करूर	pred_true
karur	करूर	करूर	pred_true
karnataka	कर्नाटका	करणातका	pred_false
karvi	कर्वी	करवी	pred_false
kurvi	कर्वी	कुर्वी	pred_false
kalmein	कलमें	कालमें	pred_false
kalmen	कलमें	कालमें	pred_false
kalraj	कलराज	कलराज	pred_true
kalika	कलिका	कालिका	pred_false
kalpanaon	कल्पनाओं	कल्पनाओं	pred_true
kalpnaon	कल्पनाओं	कल्पनाओं	pred_true
kavvaliyon	कव्वालियों	कावलालियों	pred_false
qawwaliyon	कव्वालियों	काववालयों	pred_false
kavvali	कव्वाली	काव्वाली	pred_false
qawwali	कव्वाली	कावववाली	pred_false
kashton	कष्टों	काष्टों	pred_false
kasarat	कसरत	कसरत	pred_true
kasrat	कसरत	कसरत	pred_true
kasara	कसारा	कसरा	pred_false
kasida	कसीदा	कसीदा	pred_true
kahane	कहने	कहने	pred_true
kahne	कहने	कहने	pred_true
kahlaya	कहलाया	कहलाया	pred_true
kahaniyon	कहानियों	कहनियों	pred_false
kile	क़िले	कीले	pred_false
kanji	कांजी	कांजी	pred_true
cant	कांट	कैंट	pred_false
kant	कांट	कांट	pred_true
kanti	कांति	कांटी	pred_false
kakoo	काकू	काकू	pred_true
kaku	काकू	काकू	pred_true
kaagaj	कागज़	कागज	pred_false
kaagaz	कागज़	काग़ज	pred_false
kagaj	कागज़	काग़	pred_false
kagaz	कागज़	काग़ज़	pred_false
kaaji	काजी	काजी	pred_true
kaji	काजी	काजी	pred_true
kazi	काजी	काजी	pred_true
qazi	काजी	काजी	pred_true
kajoo	काजू	काजू	pred_true
kaju	काजू	काजू	pred_true
kapadi	कापड़ी	कपड़ी	pred_false
kapdi	कापड़ी	कपड़ी	pred_false
kamraj	कामराज	कामराज	pred_true
kamottejana	कामोत्तेजना	कामोतेजना	pred_false
kamottejna	कामोत्तेजना	कामोत्ताना	pred_false
kailana	कायलाना	कैलना	pred_false
kaylana	कायलाना	कायलना	pred_false
carfi	कार्की	कारफी	pred_false
karki	कार्की	कारीकी	pred_false
kartik	कार्तिक	कार्टिक	pred_false
karyakartaon	कार्यकर्ताओं	कार्यक्रताओं	pred_false
karykartaaon	कार्यकर्ताओं	कार्यकर्ताओं	pred_true
karykartaon	कार्यकर्ताओं	कार्यकर्ताओं	pred_true
karyabhar	कार्यभार	कार्यभर	pred_false
karybhar	कार्यभार	कार्यभर	pred_false
karyarat	कार्यरत	कार्यात	pred_false
karyrat	कार्यरत	कार्यात	pred_false
kaalpi	कालपी	काल्पी	pred_false
kalapi	कालपी	कलापी	pred_false
kalpi	कालपी	कल्पी	pred_false
kalika	कालिका	कालिका	pred_true
kalighat	कालीघाट	कालीघाट	pred_true
coldvel	काल्डवेल	कोल्डवेल	pred_false
kaldvel	काल्डवेल	कालदवेल	pred_false
kaldwell	काल्डवेल	कालदवेल	pred_false
kaav	काव	काव	pred_true
kav	काव	काव	pred_true
kaasht	काश्त	काष्ट	pred_false
kasht	काश्त	काष्ट	pred_false
kasim	कासिम	कािि	pred_false
qasim	कासिम	कसिम	pred_false
kasimabad	कासिमाबाद	कसीमाबाद	pred_false
kiya	किया	किया	pred_true
kiliyan	किलियन	किलियां	pred_false
killat	किल्लत	किल्लत	pred_true
killi	किल्ली	किल्ली	pred_true
kisaani	किसानी	किसानी	pred_true
kisani	किसानी	किसनी	pred_false
kisanon	किसानों	किसनों	pred_false
keede	कीड़े	कीड़े	pred_true
kide	कीड़े	कीडे	pred_false
keynote	कीनोट	केनोटे	pred_false
kinote	कीनोट	किनोट	pred_false
kiratpur	कीरतपुर	किरतपुर	pred_false
kundal	कुंडल	कुंडल	pred_true
kundaliya	कुंडलियाँ	कुंडललय	pred_false
kundaliyan	कुंडलियाँ	कुंदलियां	pred_false
kutta	कुत्ता	कुट्ट	pred_false
kuposhit	कुपोषित	कुपोषित	pred_true
kumau	कुमाऊ	कुमा	pred_false
kumavat	कुमावत	कुमावत	pred_true
kumawat	कुमावत	कुमावत	pred_true
kural	कुराल	कुरल	pred_false
kurmi	कुर्मी	कुर्मी	pred_true
kursiyon	कुर्सियों	कुरसियों	pred_false
kush	कुश	कुश	pred_true
kushaan	कुषाण	कुशान	pred_false
kushan	कुषाण	कुशन	pred_false
kusumalataa	कुसुमलता	कुसुमालता	pred_false
kusumalta	कुसुमलता	कुसुमालता	pred_false
kusumlata	कुसुमलता	कुसुमलता	pred_true
koot	कूट	कूट	pred_true
kut	कूट	कुट	pred_false
kritika	कृतिका	कृतिका	pred_true
kpo	केपीओ	कपो	pred_false
canterbari	कैंटरबरी	कैंटरबारी	pred_false
canterbury	कैंटरबरी	कैंटरबरी	pred_true
candidate	कैंडिडेट	कैंडीडेट	pred_false
katrina	कैटरीना	कटरिना	pred_false
caitlyn	कैटलिन	कैटलिन	pred_true
cateline	कैटलिन	कैटेलिन	pred_false
catlin	कैटलिन	कैटलिन	pred_true
cadmium	कैडमियम	कैड्मियम	pred_false
catholic	कैथोलिक	कैथोलिक	pred_true
catholicon	कैथोलिकों	कैथोलिकों	pred_true
kaetholikon	कैथोलिकों	कैथोलिकों	pred_true
capacitor	कैपेसिटर	कैपेटर	pred_false
carat	कैरेट	कााा	pred_false
cavity	कैविटी	कैविटी	pred_true
cavalry	कैवेलरी	कैवलरी	pred_false
kaivelari	कैवेलरी	कैवलेरी	pred_false
complex	कॉम्प्लेक्स	कॉंपेक्स	pred_false
kocchi	कोच्चि	कोची	pred_false
kochi	कोच्चि	कोची	pred_false
corridor	कोरिडोर	कॉरिडोर	pred_false
corolla	कोरोला	कोरोला	pred_true
korola	कोरोला	कोरोला	pred_true
caolan	कोलन	कालन	pred_false
colan	कोलन	कोलन	pred_true
colon	कोलन	कोलों	pred_false
calling	कोलिंग	कॉलिंग	pred_false
koling	कोलिंग	कोलिंग	pred_true
colorado	कोलोराडो	कलरोडो	pred_false
kolorado	कोलोराडो	कोलोरोडो	pred_false
kaushal	कौशल	कौशल	pred_true
kaushalata	कौशलता	कौशलता	pred_true
kaushalta	कौशलता	कौशलता	pred_true
kaushambi	कौशाम्बी	कौषंबी	pred_false
cute	क्यूट	कट	pred_false
quete	क्यूट	क्वेट	pred_false
cube	क्यूब	क्यूब	pred_true
cubeck	क्यूबेक	क्यूबेक	pred_true
quebec	क्यूबेक	क्वेबिक	pred_false
cubes	क्यूब्स	क्यूब्स	pred_true
krantiyon	क्रांतियों	क्रांतियों	pred_true
cric	क्रिक	क्रीआईसी	pred_false
crick	क्रिक	क्रिक	pred_true
cricket	क्रिकेट	क्रिकट	pred_false
cricketer	क्रिकेटर	क्रिकटटर	pred_false
cricketing	क्रिकेटिंग	क्रिकटिंग	pred_false
kriyayog	क्रियायोग	क्रियोग	pred_false
christian	क्रिश्चयन	क्रिश्टियन	pred_false
kruger	क्रूगर	क्रगर	pred_false
craig	क्रेग	क्रायग	pred_false
creg	क्रेग	क्रेज	pred_false
cradle	क्रैडल	क्राडल	pred_false
chrom	क्रोम	क्रोम	pred_true
chrome	क्रोम	क्रोम	pred_true
client	क्लांइट	क्लाइंट	pred_false
clock	क्लाक	क्लॉक	pred_false
clasen	क्लासें	क्लासें	pred_true
classen	क्लासें	क्लासें	pred_true
classon	क्लासों	क्लासों	pred_true
clay	क्ले	क्ले	pred_true
claris	क्लेरिस	क्लारिस	pred_false
cleris	क्लेरिस	क्लीयरस	pred_false
clerys	क्लेरिस	क्लायर्स	pred_false
quantico	क्वांटिको	क्वांसिको	pred_false
queens	क्वींस	क्वींस	pred_true
kshitij	क्षितिज	क्षितिज	pred_true
shitij	क्षितिज	शीतिज	pred_false
kshin	क्षीण	क्षीन	pred_false
shin	क्षीण	शीन	pred_false
kshetron	क्षेत्रों	क्षेत्रों	pred_true
shetron	क्षेत्रों	क्षेत्रों	pred_true
khand	खंडा	खंड	pred_false
khanda	खंडा	खंडा	pred_true
khachakhach	खचाखच	खच्चाछ	pred_false
khajarana	खजराना	ख़जरना	pred_false
khajraana	खजराना	खजरना	pred_false
khajrana	खजराना	खजरना	pred_false
khatakati	खटकती	खटकती	pred_true
khatakti	खटकती	खटकी	pred_false
kihatkati	खटकती	किहटकती	pred_false
khattapan	खट्टापन	खट्टापन	pred_true
khat	खत	खाट	pred_false
khani	खनि	खानी	pred_false
khanik	खनिक	खानिक	pred_false
khanikarm	खनिकर्म	खानीकर्म	pred_false
khanikarma	खनिकर्म	खानीकर्म	pred_false
khanikarmi	खनिकर्म	खानिकर्मी	pred_false
khapat	खपत	खपट	pred_false
khariya	खरिया	खरिया	pred_true
khalnayak	खलनायक	खालायक	pred_false
khaaskar	ख़ासकर	खास्कर	pred_false
khaskar	ख़ासकर	खासकर	pred_false
khaastaur	ख़ासतौर	खासतौर	pred_false
khastaur	ख़ासतौर	खस्तौर	pred_false
khaibar	ख़ैबर	खैबर	pred_false
khyber	ख़ैबर	खेबर	pred_false
khaein	खाएं	खाएं	pred_true
khaen	खाएं	खाएं	pred_true
khayen	खाएं	खाएं	pred_true
khaate	खाते	खाते	pred_true
khaatey	खाते	खाते	pred_true
khate	खाते	खाते	pred_true
khal	खाल	खाल	pred_true
khinchakar	खिंचकर	खींचाकार	pred_false
khinchkar	खिंचकर	खींचकर	pred_false
khilana	खिलाना	खिलना	pred_false
khinchkar	खींचकर	खींचकर	pred_true
khuda	खुदा	खुड़ा	pred_false
khudai	खुदाई	खुड़ाई	pred_false
khurapka	खुरपका	खुरापका	pred_false
khurpaka	खुरपका	खुरपाका	pred_false
khurasan	खुरासान	खुरसान	pred_false
khushiyan	खुशियां	खुशियां	pred_true
khene	खेने	खेने	pred_true
khaini	खैनी	खैनी	pred_true
khairati	खैराती	खैरती	pred_false
khoikhoi	खोईखोई	खोखिए	pred_false
khoya	खोया	खोया	pred_true
gangrel	गंगरेल	गंगर्लेल	pred_false
gangaajal	गंगाजल	गंगाजल	pred_true
gangajal	गंगाजल	गंगाल	pred_false
gandaki	गंडकी	गंडाकी	pred_false
gandki	गंडकी	गंडकी	pred_true
gandh	गंध	गांध	pred_false
gandha	गंध	गांधा	pred_false
gae	गए	गाए	pred_false
gaye	गए	गाय	pred_false
gajara	गजरा	गजरा	pred_true
gajra	गजरा	गजरा	pred_true
gadkar	गडकर	गड़कर	pred_false
ganapati	गणपति	गणपती	pred_false
ganpati	गणपति	गणपती	pred_false
gatisheel	गतिशील	गतिशील	pred_true
gatishil	गतिशील	गतिशील	pred_true
gatishilata	गतिशीलता	गतिशिल्ता	pred_false
gadadhar	गदाधर	गाड़ार	pred_false
gammat	गम्मत	गमममत	pred_false
gaya	गया	गाया	pred_false
garibi	गरीबी	गारीबी	pred_false
garjana	गर्जना	गर्जना	pred_true
galgand	गलगंड	गललंंड	pred_false
gahmagahmi	गहमागहमी	गहमामी	pred_false
gemhagehmi	गहमागहमी	गेमहेगी	pred_false
ganguly	गांगुली	गंगुल्य	pred_false
gaanth	गांठ	गांठ	pred_true
ganth	गांठ	गंठ	pred_false
gaanthe	गांठे	गांठे	pred_true
ganthe	गांठे	गंठे	pred_false
ganthen	गांठें	गंठें	pred_false
ganthon	गांठों	गंथों	pred_false
gaen	गाएं	गाएं	pred_true
gayen	गाएं	गाएं	pred_true
gazi	गाज़ी	गाजी	pred_false
gajipur	गाजीपुर	गजीपुर	pred_false
gazipur	गाजीपुर	गाजीपुर	pred_true
gayatri	गायत्री	गायत्री	pred_true
gayitri	गायत्री	गायित्री	pred_false
gaytri	गायत्री	गायत्री	pred_true
gidgidate	गिड़गिड़ाते	गिजिडड़ेट	pred_false
ginate	गिनते	गिनते	pred_true
ginte	गिनते	गिंटे	pred_false
girkar	गिरकर	गिरकर	pred_true
girijaghar	गिरजाघर	गिरिजाघर	pred_false
girjaghar	गिरजाघर	गिरजाघर	pred_true
girijagharon	गिरजाघरों	गिरिजाघरों	pred_false
girjagharon	गिरजाघरों	गिरजाघारों	pred_false
girati	गिरती	गिराती	pred_false
girti	गिरती	गिरती	pred_true
girish	गिरीश	गिरिश	pred_false
guan	गुआन	गुण	pred_false
gujar	गुजार	गुजर	pred_false
gujarata	गुजारता	गुजराता	pred_false
gujarta	गुजारता	गुजरता	pred_false
gujarate	गुजारते	गुजराते	pred_false
gujarte	गुजारते	गुजरते	pred_false
gujarana	गुजारना	गुजरना	pred_false
gujarna	गुजारना	गुजरना	pred_false
gujara	गुजारा	गुजरा	pred_false
gujare	गुजारे	गुजरे	pred_false
gutta	गुट्टा	गुट्टा	pred_true
gthalidar	गुठलीदार	ग्थालीदार	pred_false
guthalidar	गुठलीदार	गुथालीदार	pred_false
gudna	गुदना	गुड़ना	pred_false
gumaan	गुमान	गुमान	pred_true
guman	गुमान	गुमान	pred_true
gulshan	गुलशन	गुल्शन	pred_false
gunga	गूंगा	गुंगा	pred_false
grihnagar	गृहनगर	गृहनगर	pred_true
gruhnagar	गृहनगर	गृहनगर	pred_true
galaxion	गैलेक्सियों	गैलकक्शन	pred_false
galaxiyon	गैलेक्सियों	गैलक्सियों	pred_false
galaxyon	गैलेक्सियों	गैलक्सियों	pred_false
gochar	गोचर	गोचर	pred_true
gouchar	गोचर	गुचार	pred_false
godara	गोदारा	गोदारा	pred_true
gopichand	गोपीचंद	गोपीचंद	pred_true
gomake	गोमके	गोमके	pred_true
gomke	गोमके	गोमके	pred_true
goel	गोयल	गोयल	pred_true
goyal	गोयल	गोयल	pred_true
gosvaami	गोस्वामी	गोस्वामी	pred_true
gosvami	गोस्वामी	गोस्वामी	pred_true
goswami	गोस्वामी	गोस्वामी	pred_true
gaumukh	गौमुख	गौमुख	pred_true
gomukh	गौमुख	गोमुख	pred_false
gaumutr	गौमूत्र	गौमूत्र	pred_true
gaumutra	गौमूत्र	गौमत्र	pred_false
gowmutra	गौमूत्र	गोममत्र	pred_false
granthiyaan	ग्रंथियां	ग्रानिथियां	pred_false
granthiyan	ग्रंथियां	ग्रानिथियां	pred_false
grandhiyon	ग्रंथियों	ग्राधियों	pred_false
granthiyon	ग्रंथियों	ग्रानथियों	pred_false
greest	ग्रीस्ट	ग्रीस्ट	pred_true
greist	ग्रीस्ट	ग्रेस्ट	pred_false
grist	ग्रीस्ट	ग्रिस्ट	pred_false
greg	ग्रेग	ग्रेज	pred_false
granite	ग्रेनाइट	ग्रानिट	pred_false
grenite	ग्रेनाइट	ग्रेनिट	pred_false
grandson	ग्रैंडसन	ग्रांडसन	pred_false
gross	ग्रॉस	ग्रोस्स	pred_false
ghataatop	घटाटोप	घटाटोप	pred_true
ghatatop	घटाटोप	घटतोट	pred_false
ghataayaa	घटाया	घटाया	pred_true
ghataya	घटाया	घटाया	pred_true
ghanakar	घनाकार	घनकर	pred_false
ghabrahat	घबराहट	घबरभाहट	pred_false
ghasi	घासी	घसी	pred_false
ghisai	घिसाई	घिसई	pred_false
ghisi	घिसी	घीसी	pred_false
ghise	घिसे	घीसे	pred_false
ghumakkadi	घुमक्कड़ी	घुमक्कदाई	pred_false
ghumakkdi	घुमक्कड़ी	घुमक्की	pred_false
ghumakkadon	घुमक्कड़ों	घूमकाकां	pred_false
ghumakkaron	घुमक्कड़ों	घूमककारों	pred_false
ghumakkdon	घुमक्कड़ों	घुमक्कों	pred_false
ghummakkadon	घुमक्कड़ों	घूम्मकाकों	pred_false
ghumaan	घुमाण	घुमान	pred_false
ghuman	घुमाण	घूमान	pred_false
ghoonsa	घूंसा	घुंसा	pred_false
ghunsa	घूंसा	घुंसा	pred_false
ghongha	घोंघा	घोंघा	pred_true
ghontane	घोंटने	घोंटने	pred_true
ghontne	घोंटने	घोंटने	pred_true
ghot	घोट	घोट	pred_true
ghodi	घोड़ी	घोड़ी	pred_true
ghost	घोस्ट	घोस्त	pred_false
changul	चंगुल	चंगुल	pred_true
chand	चंद	चांड	pred_false
chandan	चंदन	चादन	pred_false
chandana	चंदन	चंदना	pred_false
chandu	चंदू	चंडू	pred_false
chandon	चंदों	चंदों	pred_true
chandrabali	चंद्रबली	चंद्राबली	pred_false
chandramaon	चंद्रमाओं	चंद्रहमाओं	pred_false
chakatte	चकत्ते	चकतते	pred_false
chaktte	चकत्ते	चक्ते	pred_false
chakkar	चक्कर	चक्कर	pred_true
chkkar	चक्कर	चक्कर	pred_true
chakshu	चक्षु	चक्षु	pred_true
chatagaon	चटगांव	चटागाओं	pred_false
chatgaon	चटगांव	चटगाओं	pred_false
chadhane	चढ़ने	चढ़ने	pred_true
chadhne	चढ़ने	चढ़ने	pred_true
chaturdik	चतुर्दिक	चतुर्डिक	pred_false
chatunshkoniy	चतुष्कोणीय	चातुनशक्यिय	pred_false
chatushkoniy	चतुष्कोणीय	चात्ष्किय	pred_false
chatushkoniya	चतुष्कोणीय	चातुष्टिकिया	pred_false
channa	चन्ना	चन्ना	pred_true
chabate	चबाते	चबाते	pred_true
chabutare	चबूतरे	चबुतरे	pred_false
chabutre	चबूतरे	चाब्टे	pred_false
chamakna	चमकना	चमकना	pred_true
chamkana	चमकना	चमकना	pred_true
charas	चरस	चारस	pred_false
charit	चरित	चररीत	pred_false
charcha	चर्चा	चर्चा	pred_true
churcha	चर्चा	चूर्चा	pred_false
charchaon	चर्चाओं	चर्चाओं	pred_true
chalenge	चलेंगे	चलेंगे	pred_true
chlenge	चलेंगे	क्लेंगे	pred_false
chahunaur	चहुंओर	चाुनौर	pred_false
chahunor	चहुंओर	चाहूरर	pred_false
chanval	चांवल	चंवाल	pred_false
chanwal	चांवल	चंवाल	pred_false
chachaji	चाचाजी	चचाजी	pred_false
chadar	चादर	चाड़र	pred_false
chadaron	चादरों	चडदारों	pred_false
chadron	चादरों	चड्रों	pred_false
chan	चान	चैन	pred_false
chanan	चानन	चान	pred_false
chaplusi	चापलूसी	चापुसी	pred_false
chayal	चायल	चयाल	pred_false
char	चार	चर	pred_false
charon	चारों	चरों	pred_false
charge	चार्ज	चार्ज	pred_true
chart	चार्ट	चार्ट	pred_true
charton	चार्टों	चार्टन	pred_false
charts	चार्ट्स	चार्ट्स	pred_true
chaalit	चालित	चालित	pred_true
chalit	चालित	चलित	pred_false
chikitsak	चिकित्सक	चिकित्सक	pred_true
chikitsakon	चिकित्सकों	चिकित्सकों	pred_true
chikhali	चिखली	चिखली	pred_true
chiththi	चिट्ठी	चित्ठी	pred_false
chitthi	चिट्ठी	चित्ठी	pred_false
chithhi	चिठ्ठी	चिठी	pred_false
chiththi	चिठ्ठी	चित्ठी	pred_false
chitthi	चिठ्ठी	चित्ठी	pred_false
chidchidapan	चिडचिडापन	चिड़चिड़ापन	pred_false
chidchidapan	चिड़चिड़ापन	चिड़चिड़ापन	pred_true
chidhate	चिढ़ते	चिढ़ते	pred_true
chidhte	चिढ़ते	चिढ़ते	pred_true
chithrkar	चित्रकार	चित्रकर	pred_false
chitrkar	चित्रकार	चित्रकर	pred_false
chipakane	चिपकने	चिपकाने	pred_false
chipakne	चिपकने	चिपकने	pred_true
chipkane	चिपकने	चिपकाने	pred_false
chimati	चिमटी	चिमती	pred_false
chimti	चिमटी	चिमती	pred_false
chillane	चिल्लाने	चिल्ने	pred_false
chee	ची	ची	pred_true
chi	ची	चि	pred_false
chuka	चुका	चुका	pred_true
chune	चुने	चुने	pred_true
chunar	चूनर	चुनार	pred_false
changed	चेंज्ड	चेंगेड	pred_false
chetti	चेट्टी	चेत्टी	pred_false
chennai	चेन्नई	चेनाई	pred_false
chero	चेरो	चेरो	pred_true
chest	चेस्ट	चेस्ट	pred_true
championship	चैंपियनशिप	चैंपिशिप	pred_false
chor	चोर	चोर	pred_true
choro	चोरों	चोरो	pred_false
choron	चोरों	चोरों	pred_true
chauk	चौक	चौक	pred_true
chowk	चौक	चौक	pred_true
chauka	चौका	चौका	pred_true
chuka	चौका	चुका	pred_false
chaukiyan	चौकियां	चौकियां	pred_true
chauki	चौकी	चौकी	pred_true
chaukhate	चौखटे	चौखते	pred_false
chauguni	चौगुनी	चौगुनी	pred_true
chauda	चौड़ा	चौड़ा	pred_true
chaudah	चौड़ा	चौदह	pred_false
chaudahavan	चौदहवां	चौदहवान	pred_false
chaudhavan	चौदहवां	चौधावन	pred_false
chaudhawan	चौदहवां	चौधावन	pred_false
chaupati	चौपाटी	चौपती	pred_false
chupaty	चौपाटी	चुपत्य	pred_false
chaupal	चौपाल	चौपल	pred_false
chaurai	चौरई	चौराई	pred_false
chausinga	चौसिंगा	चौसिंगा	pred_true
chausingha	चौसिंगा	चौसिंगा	pred_true
chhagan	छगन	छगान	pred_false
chhabi	छबि	छाबी	pred_false
chhalla	छल्ला	छल्ला	pred_true
chhallaa	छल्ला	छल्ला	pred_true
chhaviyaan	छवियाँ	छावियां	pred_false
chhaviyan	छवियाँ	छावियां	pred_false
chhavi	छवी	छावी	pred_false
cheh	छह	चेह	pred_false
chhah	छह	छाह	pred_false
chehon	छहों	चेहों	pred_false
chhahon	छहों	छाहों	pred_false
chhai	छाई	छाई	pred_true
chhagla	छागला	छगला	pred_false
chhajan	छाजन	छज़न	pred_false
chhaati	छाती	छाती	pred_true
chhati	छाती	छटी	pred_false
chhaapemaar	छापेमार	छापेमार	pred_true
chhapemar	छापेमार	छपपेमार	pred_false
chheenk	छींक	छींक	pred_true
chhink	छींक	छिंक	pred_false
chink	छींक	चिंक	pred_false
chenkein	छींके	चेंकें	pred_false
chhekein	छींके	छेकें	pred_false
chhinke	छींके	छिंके	pred_false
chhinky	छींके	छिंकी	pred_false
chinke	छींके	चिंके	pred_false
chhudaane	छुडाने	छुड़ाने	pred_false
chhudane	छुडाने	छुड़ने	pred_false
chhupakar	छुपकर	छुपाकर	pred_false
chhupkar	छुपकर	छुपकर	pred_true
chhupkr	छुपकर	छुपक्र	pred_false
chhupata	छुपता	छुपता	pred_true
chhupta	छुपता	छुपता	pred_true
chhuptaa	छुपता	छुपता	pred_true
chhura	छुरा	छुड़ा	pred_false
chhuraa	छुरा	छुड़ा	pred_false
chhuree	छुरी	छुरी	pred_true
chhuri	छुरी	छुरी	pred_true
chhure	छुरे	छुरे	pred_true
chhootane	छूटने	छूटने	pred_true
chhutane	छूटने	छुटने	pred_false
chhutne	छूटने	छूटने	pred_true
chheter	छेत्र	छेतर	pred_false
chhetr	छेत्र	छेत्र	pred_true
chhetter	छेत्र	छेत्टर	pred_false
chhetri	छेत्री	छेत्री	pred_true
chhetthari	छेत्री	छेत्थरी	pred_false
chhetthri	छेत्री	छेत्ररी	pred_false
chai	छै	चाई	pred_false
chhai	छै	छाई	pred_false
chhe	छै	छे	pred_false
jagaega	जगाएगा	जगाएगा	pred_true
jagayega	जगाएगा	जगाएगा	pred_true
jaghaega	जगाएगा	जगाएगा	pred_true
jgaayega	जगाएगा	जगाएगा	pred_true
jgayegaa	जगाएगा	जगाएगा	pred_true
jajaon	जजों	जजाओं	pred_false
jajon	जजों	जाजों	pred_false
jad	जड़	जाड	pred_false
jadd	जड़	जा्ड	pred_false
jaddit	जड़ित	जड््ित	pred_false
jadeite	जड़ित	जड़ेत	pred_false
jadet	जड़ित	जड़ेट	pred_false
jadit	जड़ित	जाडित	pred_false
jadein	जड़ें	जड़ें	pred_true
jaden	जड़ें	जड़ें	pred_true
jatara	जतरा	जतारा	pred_false
jatra	जतरा	जत्र	pred_false
jataati	जताती	जताती	pred_true
jatatee	जताती	जताती	pred_true
jatati	जताती	जताती	pred_true
janagananaa	जनगणना	जानगनना	pred_false
janaganna	जनगणना	जानगन्न	pred_false
jangadnaa	जनगणना	जागदाना	pred_false
janganana	जनगणना	जानगना	pred_false
janganna	जनगणना	जानगना	pred_false
janajagran	जनजागरण	जनजाग्रण	pred_false
janjaagran	जनजागरण	जनजाग्रण	pred_false
janjagran	जनजागरण	जनजाग्रण	pred_false
january	जनवरी	जनुरे	pred_false
janahaani	जनहानि	जनहानी	pred_false
janahani	जनहानि	जनहानी	pred_false
janhaani	जनहानि	जनहानी	pred_false
janhani	जनहानि	जन्हनी	pred_false
jnhaani	जनहानि	जनहानी	pred_false
jamaate	जमाती	जमाते	pred_false
jamaati	जमाती	जमाती	pred_true
jamati	जमाती	जमती	pred_false
jamaaya	जमाया	जमाया	pred_true
jamaeya	जमाया	जमाएय	pred_false
jamaya	जमाया	जमाया	pred_true
jamayaa	जमाया	जमाया	pred_true
jamuai	जमुई	जमुएई	pred_false
jamuei	जमुई	जमुए	pred_false
jamui	जमुई	जमुई	pred_true
jai	जय	जै	pred_false
jay	जय	जाय	pred_false
jaidayal	जयदयाल	जैदाल	pred_false
jayadayal	जयदयाल	जायदाल	pred_false
jaydayal	जयदयाल	जायदाल	pred_false
jaibaan	जयबाण	जैबान	pred_false
jaiban	जयबाण	जैबन	pred_false
jaybaan	जयबाण	जयबान	pred_false
jayalalita	जयललिता	जायललिता	pred_false
jayalalitaa	जयललिता	जायललिता	pred_false
jayalalithaa	जयललिता	जायलाथ	pred_false
jaylalita	जयललिता	जायललिता	pred_false
jarakh	जरख	जरख	pred_true
zarakh	जरख	जरख	pred_true
jarda	जर्दा	जर्डा	pred_false
jardaa	जर्दा	जरदा	pred_false
zarda	जर्दा	जर्डा	pred_false
jalagati	जलगति	जलागती	pred_false
jalgati	जलगति	जलगती	pred_false
jalgti	जलगति	जलगती	pred_false
jalte	जलते	जलते	pred_true
jalbharav	जलभराव	जलभराव	pred_true
jalbhraav	जलभराव	जलभाराव	pred_false
jalbhrav	जलभराव	जलभभाव	pred_false
jalvaayu	जलवायु	जलवायु	pred_true
jalvayu	जलवायु	जलवायु	pred_true
jalesar	जलेसर	जलेसर	pred_true
jasmeet	जसमीत	जस्मीत	pred_false
jasmit	जसमीत	जस्मित	pred_false
jassee	जस्सी	जससी	pred_false
jassi	जस्सी	जस्सी	pred_true
jamaanaa	ज़माना	जमाना	pred_false
jamana	ज़माना	जमाना	pred_false
zamaanaa	ज़माना	ज़माना	pred_true
zamana	ज़माना	ज़मनना	pred_false
jaljale	ज़लज़ले	जललले	pred_false
zalzale	ज़लज़ले	जल्लाले	pred_false
zee	ज़ी	जी	pred_false
jubaan	ज़ुबान	जुबान	pred_false
juban	ज़ुबान	जुबान	pred_false
zuban	ज़ुबान	जुबन	pred_false
jaanch	जाँच	जांच	pred_false
jaaunch	जाँच	जानच	pred_false
janch	जाँच	जांच	pred_false
jaunch	जाँच	जौंच	pred_false
jaagriti	जागृति	जागती	pred_false
jagriti	जागृति	जागीति	pred_false
jagruti	जागृति	जागती	pred_false
jajamau	जाजमऊ	जजमा	pred_false
jajmau	जाजमऊ	जजमा	pred_false
jajmauu	जाजमऊ	जजमौ	pred_false
jaat	जात	जात	pred_true
jat	जात	जाट	pred_false
jaatak	जातक	जाटक	pred_false
jatak	जातक	जाटक	pred_false
jaatakon	जातकों	जातकों	pred_true
jaatkon	जातकों	जातकों	pred_true
jatakon	जातकों	जातकों	pred_true
jaatiyon	जातियों	जातियों	pred_true
jatiyon	जातियों	जातियों	pred_true
jaankaaron	जानकारों	जानकारों	pred_true
jaankaron	जानकारों	जानकरों	pred_false
jankaron	जानकारों	जानकरों	pred_false
jaanam	जानम	जानम	pred_true
janam	जानम	जन्म	pred_false
jaayke	जायके	जायके	pred_true
jayke	जायके	जायके	pred_true
jaawar	जावर	जावर	pred_true
zawar	जावर	जवार	pred_false
jing	जिंग	जिंग	pred_true
gin	जिन	गिन	pred_false
jeen	जिन	जीन	pred_false
jin	जिन	जीन	pred_false
ginee	जिनी	गिनी	pred_false
jinee	जिनी	जीनी	pred_false
jini	जिनी	जीनी	pred_false
geneva	जिनीवा	जेनेवा	pred_false
jeneva	जिनीवा	जेनेवा	pred_false
jiniva	जिनीवा	जीनीवा	pred_false
gypsy	जिप्सी	जिप्सी	pred_true
jimme	जिम्मे	जिम्मे	pred_true
jiya	जिया	जीया	pred_false
gic	जीआईसी	जीईसी	pred_false
gr	जीआर	गीआर	pred_false
gm	जीएम	जीएम	pred_true
gsm	जीएसएम	जीएसएम	pred_true
gtod	जीतोड़	ग्टोड	pred_false
gtor	जीतोड़	ग्टोर	pred_false
jeetod	जीतोड़	जीतोड़	pred_true
jitod	जीतोड़	जीतोड़	pred_true
jean	जीन	जीन	pred_true
jeen	जीन	जीन	pred_true
jin	जीन	जीन	pred_true
jeenon	जीनों	जीनों	pred_true
jinon	जीनों	जीनों	pred_true
jeepney	जीपनी	जीपने	pred_false
jipani	जीपनी	जिपानी	pred_false
jeeyo	जीयो	जीयो	pred_true
jio	जीयो	जिओ	pred_false
jiyo	जीयो	जीयो	pred_true
jeera	जीरा	जीरा	pred_true
jira	जीरा	जीरा	pred_true
jeevant	जीवंत	जीवंत	pred_true
jivant	जीवंत	जीवंत	pred_true
jeevan	जीवन	जीवन	pred_true
jeewan	जीवन	जीवान	pred_false
jivan	जीवन	जीवन	pred_true
jiwan	जीवन	जीवन	pred_true
jeevanshaili	जीवनशैली	जीवनशाली	pred_false
jivanshaili	जीवनशैली	जीवनशाली	pred_false
jeevniyaan	जीवनियां	जीवनियां	pred_true
jivaniya	जीवनियां	जीवनीय	pred_false
jivaniyaan	जीवनियां	जीवनियां	pred_true
jivaniyan	जीवनियां	जीवनियां	pred_true
jeevraaj	जीवराज	जीवराज	pred_true
jivraj	जीवराज	जीवराज	pred_true
jua	जुए	जुआ	pred_false
jue	जुए	जूए	pred_false
juye	जुए	जुए	pred_true
jutee	जुटी	जुती	pred_false
juti	जुटी	जूटी	pred_false
judaai	जुड़ाई	जुड़ाई	pred_true
judae	जुड़ाई	जुड़ए	pred_false
judai	जुड़ाई	जुड़ई	pred_false
judaai	जुदाई	जुड़ाई	pred_false
judai	जुदाई	जुड़ई	pred_false
junoon	जुनून	जूनून	pred_false
junun	जुनून	जुनून	pred_true
junooni	जुनूनी	जूनूनी	pred_false
jununi	जुनूनी	जुनूनी	pred_true
jubair	जुबेर	जुबैर	pred_false
juber	जुबेर	जुबेर	pred_true
zubair	जुबेर	जुबैर	pred_false
juraab	जुराब	जुराब	pred_true
jurab	जुराब	जुराब	pred_true
julaahon	जुलाहों	जुलाहों	pred_true
julahon	जुलाहों	जुलाहों	pred_true
julmon	जुल्मों	जुल्मों	pred_true
zulmon	जुल्मों	जुल्मों	pred_true
jood	जूड	जूद	pred_false
jud	जूड	जुड	pred_false
junagadh	जूनागढ	जुनागढ़	pred_false
junagarh	जूनागढ	जुनागढ़	pred_false
junior	जूनियर	जुनियर	pred_false
jealous	जूलूस	जीलोस	pred_false
juloos	जूलूस	जुलूस	pred_false
julus	जूलूस	जुलूस	pred_false
jetha	जेठा	जेठा	pred_true
jenner	जेनर	जेनर	pred_true
generic	जेनरिक	जेनेरिक	pred_false
jenrick	जेनरिक	जेनरिक	pred_true
generat	जेनरेट	जनरेट	pred_false
generate	जेनरेट	जनरेट	pred_false
jenee	जेनी	जेनी	pred_true
jenni	जेनी	जेनी	pred_true
jenny	जेनी	जेनी	pred_true
james	जेम्स	जमेस	pred_false
jeremy	जेरेमी	जेरेमी	pred_true
gerome	जेरोम	जेरोम	pred_true
jerome	जेरोम	जेरोम	pred_true
jacks	जैक्स	जैक्स	pred_true
jain	जैन	जैन	pred_true
gene	जैने	जेने	pred_false
jaine	जैने	जैने	pred_true
jaino	जैनों	जैनो	pred_false
jainon	जैनों	जैनों	pred_true
jerry	जैरी	जेरी	pred_false
jasper	जैस्पर	जसपर	pred_false
jogging	जॉगिंग	जोगिंग	pred_false
johnson	जॉनसन	जॉनसन	pred_true
jobs	जॉब्स	जोब्स	pred_false
jockey	जोकि	जोके	pred_false
joki	जोकि	जोकी	pred_false
jokhim	जोखिम	जोखिम	pred_true
joddta	जोड़ता	जोड़ता	pred_true
jodta	जोड़ता	जोड़ता	pred_true
jorhta	जोड़ता	जोड़ता	pred_true
jodiyon	जोड़ियों	जोड़ियों	pred_true
jodo	जोड़ो	जोडो	pred_false
jaun	जौं	जौन	pred_false
gyatavya	ज्ञातव्य	ज्ञातव्य	pred_true
gyatvy	ज्ञातव्य	ज्ञावत्य	pred_false
gyapit	ज्ञापित	ज्ञापित	pred_true
jyotiba	ज्योतिबा	ज्योतिबा	pred_true
joint	ज्वाइंट	जॉयंट	pred_false
jvar	ज्वार	ज्वर	pred_false
jwar	ज्वार	ज्वर	pred_false
jvaaron	ज्वारों	ज्वारों	pred_true
jvaron	ज्वारों	ज्वरों	pred_false
jwaron	ज्वारों	ज्वरों	pred_false
jewellers	ज्वेलर्स	ज्वेलर्स	pred_true
jh	झ	झ	pred_true
jha	झ	झा	pred_false
jhalakti	झलकती	झलकती	pred_true
jhalkati	झलकती	झलकती	pred_true
jhalla	झल्ला	झल्ला	pred_true
jhankana	झांकना	झंकना	pred_false
jhankna	झांकना	झनकना	pred_false
jheel	झील	झील	pred_true
jhil	झील	झील	pred_true
jheelon	झीलों	झीलों	pred_true
jhilon	झीलों	झिलों	pred_false
jhuthala	झुठला	झूठला	pred_false
jhuthla	झुठला	झुठला	pred_true
jhuthalane	झुठलाने	झूठलने	pred_false
jhuthlane	झुठलाने	झुठलने	pred_false
tankaar	टंकार	टंकार	pred_true
tankar	टंकार	टैंकर	pred_false
takara	टकरा	टकरा	pred_true
takra	टकरा	टकरा	pred_true
takaraon	टकरावों	टकराओं	pred_false
takravon	टकरावों	टकरावों	pred_true
tapakti	टपकती	तपकती	pred_false
tapkati	टपकती	तपकती	pred_false
time	टाइम	टाइम	pred_true
timer	टाइमर	टाइमर	pred_true
taoo	टाऊ	ताऊ	pred_false
tau	टाऊ	ताऊ	pred_false
tapoowo	टापुओं	टापू	pred_false
tapuon	टापुओं	तापूओं	pred_false
tapuwo	टापुओं	तापू	pred_false
tied	टायर्ड	टाइड	pred_false
tired	टायर्ड	टायर्ड	pred_true
tyred	टायर्ड	टायर्ड	pred_true
tarch	टार्च	तर्च	pred_false
torch	टार्च	टॉर्च	pred_false
tik	टिक	टीक	pred_false
teap	टिप	टीप	pred_false
tip	टिप	टीप	pred_false
tippanikar	टिप्पणीकार	टिप्पानिकार	pred_false
tippnikar	टिप्पणीकार	टिप्पीकार	pred_false
tivolee	टिवोली	टिवोली	pred_true
tivoli	टिवोली	टिवोली	pred_true
teekamgarh	टीकमगढ़	टीकंगढ़	pred_false
tikamgarh	टीकमगढ़	टिकमगढ़	pred_false
teekon	टीकों	टीकों	pred_true
tikon	टीकों	टीकों	pred_true
two	टु	ट्वो	pred_false
tension	टेंशन	टेंसन	pred_false
tenis	टेनिस	टेनिस	pred_true
tennis	टेनिस	टेनीस	pred_false
taste	टेस्ट	तस्ते	pred_false
test	टेस्ट	टेस्ट	pred_true
tasting	टेस्टिंग	टस्टिंग	pred_false
testing	टेस्टिंग	टेस्टिंग	pred_true
tainin	टैनिन	तैनिन	pred_false
tenin	टैनिन	टेनिन	pred_false
tanish	टैनिस	तानीश	pred_false
tennis	टैनिस	टेनीस	pred_false
taboo	टैबू	तबबू	pred_false
taiboo	टैबू	तैबू	pred_false
taobao	टैबू	ताबाओ	pred_false
tonic	टॉनिक	टोनिक	pred_false
tonga	टोंगा	टोंगा	pred_true
toka	टोका	टॉका	pred_false
tuesday	ट्यूजडे	टुस्डे	pred_false
tuning	ट्यूनिंग	ट्यूंिंग	pred_false
tuberculosis	ट्यूबरक्यूलोसिस	टॉर्ब्किस्स	pred_false
tuberkyulosis	ट्यूबरक्यूलोसिस	टुब्रक्युसिस	pred_false
truck	ट्रक	ट्रीक	pred_false
trangistor	ट्रांजिस्टर	ट्रांजिस्टर	pred_true
tranjister	ट्रांजिस्टर	ट्रांजीस्टर	pred_false
transistor	ट्रांजिस्टर	ट्रांसिस्टर	pred_false
transfer	ट्रान्सफर	ट्रांसफर	pred_false
tribunal	ट्रिब्युनल	ट्रिबिनूल	pred_false
tribunal	ट्रिब्यूनल	ट्रिबिनूल	pred_false
trubyunal	ट्रिब्यूनल	ट्रिब्यूनल	pred_true
truth	ट्रुथ	तृथ	pred_false
tuth	ट्रुथ	तूथ	pred_false
traded	ट्रेडेड	ट्रेड	pred_false
trabal	ट्रेबल	ट्राबल	pred_false
trebal	ट्रेबल	ट्रेबल	pred_true
trouble	ट्रेबल	ट्रॉबल	pred_false
traip	ट्रैप	ट्राइप	pred_false
trap	ट्रैप	ट्राप	pred_false
trot	ट्रॉट	ट्रोत	pred_false
trott	ट्रॉट	ट्रोट	pred_false
thakkar	ठक्कर	ठक्कर	pred_true
thakkr	ठक्कर	ठक्कर	pred_true
thaharne	ठहरने	ठहरने	pred_true
thahrane	ठहरने	ठहराने	pred_false
theharne	ठहरने	ठहरने	pred_true
thikane	ठिकाने	ठिकने	pred_false
thumari	ठुमरी	थुमारी	pred_false
thumri	ठुमरी	थुमरी	pred_false
theinga	ठेंगा	ठेंगा	pred_true
thenga	ठेंगा	ठेंगा	pred_true
thengaa	ठेंगा	ठेंगा	pred_true
daglas	डगलस	डागलस	pred_false
douglas	डगलस	डोगलास	pred_false
dabhara	डभरा	दभारा	pred_false
dabhra	डभरा	दाभरा	pred_false
dabhoi	डभोई	दाोई	pred_false
dam	डम	दम	pred_false
dum	डम	दूम	pred_false
darate	डराते	दरते	pred_false
daratey	डराते	डरतते	pred_false
daravani	डरावनी	दरवानी	pred_false
darawani	डरावनी	दारावनी	pred_false
dravani	डरावनी	द्रवानी	pred_false
down	डाउन	डाउन	pred_true
daak	डाक	दाक	pred_false
dak	डाक	डाक	pred_true
daka	डाका	डाका	pred_true
dabi	डाबी	दबी	pred_false
dabolim	डाबोलिम	डाबोलिम	pred_true
dinosaur	डायनासोर	दिनोसर	pred_false
diaries	डायरीज	डायरिस	pred_false
dit	डिट	दिट	pred_false
depthiriya	डिप्थीरिया	दिप्तिरीय	pred_false
diphtheria	डिप्थीरिया	दिपहेतराया	pred_false
de	डीई	दे	pred_false
dealership	डीलरशिप	डेलेरिप्प	pred_false
dvc	डीवीसी	डीवीसी	pred_true
dubaana	डुबाना	दुबना	pred_false
dubana	डुबाना	डुबना	pred_false
dubona	डुबोना	दूबना	pred_false
dulne	डुलने	डुलने	pred_true
doonarpur	डूंगरपुर	दुनरपुर	pred_false
doongarpur	डूंगरपुर	दुनग्रपुर	pred_false
dungarpur	डूंगरपुर	दुनगरपुर	pred_false
dungerpur	डूंगरपुर	दुनग्रुर	pred_false
dubana	डूबना	डुबना	pred_false
dubna	डूबना	डुबना	pred_false
dangerous	डेंजरस	डेंगरसस	pred_false
daisy	डेजी	दैस्य	pred_false
dazy	डेजी	देजी	pred_false
deji	डेजी	देजी	pred_false
deputy	डेप्युटी	डिप्टी	pred_false
davidson	डेविडसन	डेविसन	pred_false
devidson	डेविडसन	डेविडसन	pred_true
davey	डेवी	देवे	pred_false
devi	डेवी	देवी	pred_false
dewey	डेवी	देवे	pred_false
destination	डेस्टिनेशन	डेस्टीनेशन	pred_false
datson	डैटसन	दास्तों	pred_false
datsun	डैटसन	दास्न	pred_false
daddy	डैडी	दाद्	pred_false
dark	डॉर्क	डर्क	pred_false
dork	डॉर्क	डोर्क	pred_false
dose	डोज	डोस	pred_false
domenic	डोमेनिक	डोमेनिक	pred_true
doranda	डोरंडा	डोरंडा	pred_true
dolane	डोलने	डोलने	pred_true
dolne	डोलने	डोलने	pred_true
dual	ड्युअल	डुएल	pred_false
duak	ड्यूक	दुक	pred_false
duke	ड्यूक	डुके	pred_false
drame	ड्रामे	ड्रेम	pred_false
dramen	ड्रामे	ड्रैम	pred_false
drager	ड्रेजर	ड्रेजर	pred_true
dredger	ड्रेजर	ड्रेजर	pred_true
dreijer	ड्रेजर	ड्रीजर	pred_false
dhakaal	ढकाल	ढकाल	pred_true
dhakal	ढकाल	ढकाल	pred_true
dhakkal	ढकाल	ढक्काल	pred_false
dhkal	ढकाल	ढकाल	pred_true
dhale	ढले	ढाले	pred_false
dhoondh	ढूंढ	ढूंध	pred_false
dhundh	ढूंढ	ढुंध	pred_false
dhoondhata	ढूंढता	ढूंढता	pred_true
dhundhata	ढूंढता	ढूंढता	pred_true
dhundhta	ढूंढता	ढूंढता	pred_true
dhoondhi	ढूंढी	ढूंधी	pred_false
dhundhi	ढूंढी	ढुंधी	pred_false
tanjavur	तंजावुर	तंजावूर	pred_false
thanjavur	तंजावुर	तंजावूर	pred_false
tantr	तंत्र	टंत्र	pred_false
tantra	तंत्र	तंत्र	pred_true
tantrikao	तंत्रिकाओं	तंत्रिकाओ	pred_false
tantrikaon	तंत्रिकाओं	तंत्रिकाओं	pred_true
tantro	तंत्रों	टंत्रो	pred_false
tantron	तंत्रों	टंत्रों	pred_false
tagade	तगड़े	टगड़े	pred_false
tagde	तगड़े	टागड़े	pred_false
tadipaar	तड़ीपार	तदीपार	pred_false
tadipar	तड़ीपार	तदीपार	pred_false
tani	तनी	तानी	pred_false
tapan	तपन	टापन	pred_false
tarafa	तरफा	ताराफा	pred_false
tarfa	तरफा	तर्फा	pred_false
tarabganj	तरबगंज	तारंगंज	pred_false
taras	तरस	तरस	pred_true
taraash	तराश	तराश	pred_true
tarash	तराश	तारश	pred_false
tarashay	तराशे	तराशय	pred_false
tarashe	तराशे	तररशश	pred_false
tareeko	तरीको	तरीको	pred_true
tariko	तरीको	तारिको	pred_false
tark	तर्क	तर्क	pred_true
tarkvaad	तर्कवाद	तरक्वाद	pred_false
tarkvad	तर्कवाद	तरक्वाद	pred_false
tarkwaad	तर्कवाद	तरक्वाड	pred_false
tarko	तर्कों	टरको	pred_false
tarkon	तर्कों	तरकों	pred_false
talabgaar	तलबगार	तललागार	pred_false
talabgar	तलबगार	तलबागार	pred_false
talbagaar	तलबगार	तलबागार	pred_false
talbagar	तलबगार	तलबगार	pred_true
talawe	तलवे	तलावे	pred_false
talve	तलवे	तलवे	pred_true
talawon	तलवों	तलावों	pred_false
talvon	तलवों	तलवों	pred_true
tahakhana	तहखाना	तहखाना	pred_true
tahkhaana	तहखाना	तहखाना	pred_true
tahkhana	तहखाना	तहखाना	pred_true
taantaa	तांता	तांता	pred_true
tanta	तांता	टंंटा	pred_false
tambe	तांबे	तांबे	pred_true
tanbe	तांबे	तंबे	pred_false
taaja	ताजा	ताजा	pred_true
taajaa	ताजा	ताजा	pred_true
taaza	ताजा	ताजा	pred_true
taja	ताजा	ताजा	pred_true
taza	ताजा	ताजा	pred_true
tansen	तानसेन	तैंसे	pred_false
taapmaanon	तापमानों	तापमानों	pred_true
tapmano	तापमानों	तप्पनों	pred_false
tapmanon	तापमानों	तप्पानों	pred_false
taapti	ताप्ती	ताप्ती	pred_true
tapti	ताप्ती	तप्ती	pred_false
tarabai	ताराबाई	तरबाई	pred_false
taseer	तासीर	तसीीर	pred_false
tasir	तासीर	तसीीर	pred_false
taahi	ताहि	ताही	pred_false
tahi	ताहि	तही	pred_false
tikone	तिकोने	टिकोन	pred_false
tirupati	तिरूपति	तिरुपति	pred_false
tiwari	तिवारी	तिवाड़ी	pred_false
ti	ती	ती	pred_true
teer	तीर	तीर	pred_true
tir	तीर	तीर	pred_true
teeron	तीरों	तीरों	pred_true
tiron	तीरों	तिरों	pred_false
tirthatan	तीर्थाटन	तीर्थनान	pred_false
tungnath	तुंगनाथ	टुन्नााथ	pred_false
tughlaq	तुगलक	टुघलक	pred_false
tuglak	तुगलक	टुग्लक	pred_false
tughlakabad	तुगलकाबाद	टुगकालाबाद	pred_false
tughlaqabad	तुगलकाबाद	टुगलाड़ाड़	pred_false
tuglakabad	तुगलकाबाद	टुग्लााबाद	pred_false
tugalaki	तुगलकी	टुगलाकी	pred_false
tugalki	तुगलकी	टुगलकी	pred_false
tuglaki	तुगलकी	टुग्लकी	pred_false
tufail	तुफैल	तुफैल	pred_true
tejaji	तेजाजी	तेजाजी	pred_true
teji	तेजी	तेजी	pred_true
tel	तेल	टेल	pred_false
telon	तेलों	टेलों	pred_false
to	तो	टू	pred_false
toh	तो	तोह	pred_false
taul	तौल	टाउल	pred_false
tyohaar	त्यौहार	त्योहार	pred_false
tyohar	त्यौहार	त्योहार	pred_false
tyoihar	त्यौहार	त्योहार	pred_false
tyauharon	त्यौहारों	त्यूहारों	pred_false
tyoharon	त्यौहारों	त्योहारों	pred_false
tyoiharon	त्यौहारों	त्योहारों	pred_false
trijata	त्रिजटा	त्रिजता	pred_false
trijta	त्रिजटा	त्रिजता	pred_false
triya	त्रिया	त्रिया	pred_true
tremasik	त्रैमासिक	ट्रेमासिजिक	pred_false
trimasik	त्रैमासिक	त्रिसामासिक	pred_false
tse	त्से	तीस	pred_false
thaki	थकी	ठकी	pred_false
thki	थकी	ठकी	pred_false
tharti	थर्टी	थरती	pred_false
thirty	थर्टी	थिर्टी	pred_false
thane	थाणे	थाने	pred_false
thaanvi	थानवी	ठानवी	pred_false
thanvi	थानवी	ठनवी	pred_false
theateron	थिएटरों	थेटेरों	pred_false
theatron	थिएटरों	थेत्रों	pred_false
theaters	थिएटर्स	थीट्र्स	pred_false
theater	थियेटर	थेटर	pred_false
theatre	थियेटर	थेत्रे	pred_false
theateron	थियेटरों	थेटेरों	pred_false
theatron	थियेटरों	थेत्रों	pred_false
thitron	थियेटरों	थित्रों	pred_false
theaters	थियेटर्स	थीट्र्स	pred_false
theatrs	थियेटर्स	थेट्र्स	pred_false
thiyeters	थियेटर्स	थिय्टिसर्स	pred_false
thirake	थिरके	थिरके	pred_true
thirke	थिरके	थिरके	pred_true
thief	थीफ	थीफ	pred_true
then	थेन	थेन	pred_true
theni	थेनी	ठेनी	pred_false
thailee	थैली	थैली	pred_true
thaili	थैली	थैली	pred_true
thaile	थैले	थैले	pred_true
dang	दंग	डैंग	pred_false
danga	दंगा	डांगा	pred_false
dangon	दंगों	डांगों	pred_false
dampati	दंपति	दामपती	pred_false
danpati	दंपति	दानपती	pred_false
dampatiyon	दंपतियों	दाप्ततियों	pred_false
dampattiyon	दंपतियों	दामपत्तियों	pred_false
danptiyon	दंपतियों	दांपतीयों	pred_false
dadreva	ददरेवा	दारेववा	pred_false
dadrewa	ददरेवा	दारेवा	pred_false
damoh	दमोह	दमोह	pred_true
dardara	दरदरा	दरदारा	pred_false
dardraa	दरदरा	दर्द्रा	pred_false
durdhara	दरदरा	दुर्धरा	pred_false
darmiyaan	दरमियान	दामियां	pred_false
darmiyan	दरमियान	दामियां	pred_false
darjano	दर्जनों	दरजानों	pred_false
darjanon	दर्जनों	दरजानों	pred_false
darp	दर्प	डर्प	pred_false
darra	दर्रा	डरा	pred_false
dalbadal	दलबदल	दललबड़ल	pred_false
dalbadl	दलबदल	डललबड	pred_false
dali	दली	डली	pred_false
dastaanaa	दस्ताना	दस्ताना	pred_true
dastana	दस्ताना	दस्ताना	pred_true
dastavej	दस्तावेज	दस्तवेज	pred_false
dahan	दहन	दहन	pred_true
dahal	दहल	दहाल	pred_false
da	दा	डा	pred_false
daakhil	दाखिल	दाखिल	pred_true
dakhil	दाखिल	दाखिल	pred_true
daakhile	दाखिले	दाखिले	pred_true
dakhile	दाखिले	दाखिले	pred_true
daataa	दाता	दाता	pred_true
data	दाता	डाता	pred_false
dadari	दादरी	दादारी	pred_false
daanshil	दानशील	दानशील	pred_true
danshil	दानशील	दैशिल	pred_false
daabholkar	दाभोलकर	दाभोलकर	pred_true
dabholkar	दाभोलकर	दाभोलकर	pred_true
damale	दामले	डमले	pred_false
damle	दामले	डमले	pred_false
dayitv	दायित्व	दायित्व	pred_true
dayitva	दायित्व	दायित्व	pred_true
dayitwa	दायित्व	दायतवव	pred_false
dayitvon	दायित्वों	दायित्वों	pred_true
dayityon	दायित्वों	दायत्यों	pred_false
darul	दारूल	दारुल	pred_false
daav	दाव	दाव	pred_true
daaw	दाव	दाव	pred_true
dav	दाव	डाएव	pred_false
daw	दाव	डा	pred_false
daah	दाह	डाह	pred_false
dah	दाह	दाह	pred_true
dikhla	दिखला	दिखला	pred_true
dikhlaa	दिखला	दिखला	pred_true
dikhaaiye	दिखाइये	दिखाइए	pred_false
dikhaiye	दिखाइये	दिखाइए	pred_false
dikhaai	दिखाई	दिखाई	pred_true
dikhai	दिखाई	दिखाई	pred_true
dikhayi	दिखाई	दिखाई	pred_true
dikhaaee	दिखाईं	दिखाए	pred_false
dikhaai	दिखाईं	दिखाई	pred_false
dikhaain	दिखाईं	दिखाएं	pred_false
dikhaee	दिखाईं	दिखाए	pred_false
dikhai	दिखाईं	दिखाई	pred_false
dikhayin	दिखाईं	दिखाएं	pred_false
dikhai	दिखायी	दिखाई	pred_false
dikhayi	दिखायी	दिखाई	pred_false
dikhaai	दिखार्इ	दिखाई	pred_false
dikhae	दिखार्इ	दिखाए	pred_false
dikhai	दिखार्इ	दिखाई	pred_false
dikhayi	दिखार्इ	दिखाई	pred_false
dita	दिता	दिटा	pred_false
ditaa	दिता	दिता	pred_true
dinaank	दिनांक	दीनांक	pred_false
dinank	दिनांक	दीनांक	pred_false
dirham	दिरहम	दीरहाम	pred_false
dilaaye	दिलाये	दिलाए	pred_false
dilaye	दिलाये	दिलाए	pred_false
deewani	दिवानी	दीवानी	pred_false
diwani	दिवानी	दिवानी	pred_true
divy	दिव्य	दिवीय	pred_false
divya	दिव्य	दिव्य	pred_true
divyata	दिव्यता	दिव्याता	pred_false
divya	दिव्या	दिव्य	pred_false
deepan	दीपन	दीपन	pred_true
deepn	दीपन	दीप्न	pred_false
dipan	दीपन	दीपान	pred_false
deepsingh	दीपसिंह	दीप्सिंह	pred_false
dipsingh	दीपसिंह	डीपिसिंह	pred_false
deepika	दीपिका	दीपीका	pred_false
dipika	दीपिका	दीपिका	pred_true
deeya	दीया	दीया	pred_true
diya	दीया	दिया	pred_false
dukaanon	दुकानों	दुकानों	pred_true
dukanon	दुकानों	दुकानों	pred_true
dukke	दुक्के	डुक्के	pred_false
dukhan	दुखन	दुखन	pred_true
dukhit	दुखित	दुखित	pred_true
dukhiyon	दुखियों	दुखियों	pred_true
dukhon	दुखों	दुखों	pred_true
dubhashiyon	दुभाषियों	दुभाषियों	pred_true
durgun	दुर्गुण	दुर्गुण	pred_true
durghatna	दुर्घटना	दुर्घटना	pred_true
durghtna	दुर्घटना	दुर्घटना	pred_true
duneerti	दुर्नीति	दुनिर्ती	pred_false
durniti	दुर्नीति	दूरनीति	pred_false
durbhiksh	दुर्भिक्ष	दुर्भिक्ष	pred_true
duvidhaaen	दुविधाएं	दुविधाएं	pred_true
duvidhaayein	दुविधाएं	दुविधाएं	pred_true
duvidhaen	दुविधाएं	दुविधाएं	pred_true
duwaidhaayein	दुविधाएं	दुविधाएं	pred_true
dune	दूने	दुने	pred_false
doordarshan	दूरदर्शन	दूरदर्शन	pred_true
durdarshan	दूरदर्शन	दुरदर्शन	pred_false
dradh	दृढ़	द्रद्ध	pred_false
dridh	दृढ़	दृद्ध	pred_false
dekhoge	देखोगे	देखोगे	pred_true
denevaali	देनेवाली	देनेवाली	pred_true
denevali	देनेवाली	देनेवाली	pred_true
denewaali	देनेवाली	देनेवाली	pred_true
denewali	देनेवाली	देनेवाली	pred_true
deonar	देवनार	देयोनर	pred_false
devnaar	देवनार	देवनार	pred_true
devnar	देवनार	देवनार	pred_true
devaapur	देवापुर	देवापुर	pred_true
devapur	देवापुर	देवपुर	pred_false
devi	देवी	देवी	pred_true
devisingh	देवीसिंह	डेविजिंह	pred_false
devisinh	देवीसिंह	डेविसिह	pred_false
deshkaal	देशकाल	देशकाल	pred_true
deshkal	देशकाल	देशकाल	pred_true
deshke	देशके	देशके	pred_true
desai	देसाई	देसई	pred_false
doge	दोगे	डोगे	pred_false
dvadash	द्वादश	द्वदाश	pred_false
dwaadas	द्वादश	द्वादस	pred_false
dvivedi	द्विवेदी	द्वीवेदी	pred_false
dwivedi	द्विवेदी	द्वीवेदी	pred_false
dhande	धंधे	धंडड़े	pred_false
dhandhe	धंधे	धंधे	pred_true
dhndhe	धंधे	धंढे	pred_false
dhandhon	धंधों	धंधों	pred_true
dhandon	धंधों	धंडों	pred_false
dhakelte	धकेलते	ढकेलते	pred_false
dhkelate	धकेलते	धकेलते	pred_true
dhatana	धटना	ढाना	pred_false
dhatna	धटना	ढानता	pred_false
dhankuber	धनकुबेर	धनकुबर	pred_false
dhanadhany	धनधान्य	धनधान्य	pred_true
dhandhaanya	धनधान्य	धंधान्य	pred_false
dhandhany	धनधान्य	धंधनीय	pred_false
dhandhanya	धनधान्य	धंधन्य	pred_false
dhamkaataa	धमकाता	धमकता	pred_false
dhamkata	धमकाता	धमकता	pred_false
dhamm	धम्म	धम्म	pred_true
dhamma	धम्मा	धम्मा	pred_true
dhammaa	धम्मा	धम्मा	pred_true
dharmnath	धर्मनाथ	धर्मनाथ	pred_true
dharmraj	धर्मराज	धर्माज	pred_false
dharmesh	धर्मेश	धर्मेश	pred_true
dhasmaanaa	धस्माना	धासमाना	pred_false
dhasmana	धस्माना	धासमाना	pred_false
dhaak	धाक	ढाक	pred_false
dhak	धाक	ढक	pred_false
dhaaga	धागा	धागा	pred_true
dhaagaa	धागा	धागा	pred_true
dhaga	धागा	धागा	pred_true
dhaatuein	धातुएं	धातुएं	pred_true
dhaatuyein	धातुएं	धातुएं	pred_true
dhtuen	धातुएं	धट्यून	pred_false
dhaarak	धारक	धारक	pred_true
dharak	धारक	धारक	pred_true
dhaari	धारी	धारी	pred_true
dhari	धारी	धारी	pred_true
dhuan	धुआं	धुआन	pred_false
dhunaai	धुनाई	धुनाई	pred_true
dhunai	धुनाई	धुनाई	pred_true
dhuriya	धुरिया	धूरिया	pred_false
dhuriyaa	धुरिया	धूरिया	pred_false
dhuni	धूनी	धुनी	pred_false
dhairyavaan	धैर्यवान	धैर्यवान	pred_true
dhairyawan	धैर्यवान	धैर्यवान	pred_true
dhiryavan	धैर्यवान	धिर्यवान	pred_false
dhiryawaan	धैर्यवान	धिर्यवान	pred_false
dhokebaaj	धोखेबाज	धोकेबाज	pred_false
dhokebaaz	धोखेबाज	धोकेबाज	pred_false
dhokebaj	धोखेबाज	धोकेबाज	pred_false
dhokebaz	धोखेबाज	धोकेबाज	pred_false
dhokhebaaj	धोखेबाज	धोखेबाज	pred_true
dhokhebaj	धोखेबाज	धोखेबाज	pred_true
dhona	धोना	ढोना	pred_false
dhonaa	धोना	ढोना	pred_false
dhoraaji	धोराजी	धोराजी	pred_true
dhoraji	धोराजी	धोराजी	pred_true
dhoron	धोरों	धोरों	pred_true
dhyeyavaadi	ध्येयवादी	ध्यावादी	pred_false
dhyeywadi	ध्येयवादी	ध्येवादी	pred_false
dyeyvadi	ध्येयवादी	दायववादी	pred_false
dhrupad	ध्रुपद	धुरपद	pred_false
drupad	ध्रुपद	द्रुपद	pred_false
nandanvan	नंदनवन	नंदवनन	pred_false
nadsa	नक्सल	नदसा	pred_false
naksal	नक्सल	नक्सल	pred_true
naxal	नक्सल	नक्सल	pred_true
naksalavaad	नक्सलवाद	नक्सवाद	pred_false
naksalwaad	नक्सलवाद	नक्सवाद	pred_false
naksalwad	नक्सलवाद	नक्सवाद	pred_false
naxalvaaad	नक्सलवाद	नक्सवाल	pred_false
naxalwaad	नक्सलवाद	नक्सवाल	pred_false
naksaliyon	नक्सलियों	नक्सियों	pred_false
naxaliyon	नक्सलियों	नक्सालियों	pred_false
naksali	नक्सली	नक्साली	pred_false
naxali	नक्सली	नक्साली	pred_false
nagaada	नगाड़ा	नगाड़ा	pred_true
nagaadaa	नगाड़ा	नगाड़ा	pred_true
nagaaraa	नगाड़ा	नगारा	pred_false
nageene	नगीने	नागीने	pred_false
nagine	नगीने	नाइने	pred_false
najarandaaj	नजरंदाज	नज़रंदाज	pred_false
najarandaaz	नजरंदाज	नज़रंदाज	pred_false
nazarandaaj	नजरंदाज	नज़रंदाज	pred_false
nazarandaaz	नजरंदाज	नज़रंदाज	pred_false
nazarandaz	नजरंदाज	नज़रंदाज	pred_false
najraane	नजराने	नज़राने	pred_false
nazraane	नजराने	नज़राने	pred_false
najariyon	नजरियों	नज़रियों	pred_false
najriyon	नजरियों	नज़रियों	pred_false
najron	नजरों	नज़रों	pred_false
najeeb	नजीब	नजीब	pred_true
najib	नजीब	नाजीब	pred_false
najibabaad	नजीबाबाद	नाजीबाबाद	pred_false
najibabad	नजीबाबाद	नाजीबाबाद	pred_false
najeem	नजीम	नजीम	pred_true
najim	नजीम	नाजिम	pred_false
nazeem	नजीम	नजीम	pred_true
nana	नना	नाना	pred_false
nanaa	नना	नाना	pred_false
nna	नना	नना	pred_true
nanhe	नन्हें	नन्हे	pred_false
nanhein	नन्हें	नन्हें	pred_true
nabj	नब्ज़	नब्ज	pred_false
nabja	नब्ज़	नब्जा	pred_false
nabz	नब्ज़	नब्ज	pred_false
namkeen	नमकीन	नमकीन	pred_true
namkin	नमकीन	नाक्मीन	pred_false
narnaari	नरनारी	ननरारी	pred_false
narnari	नरनारी	नारनरी	pred_false
narbhakshi	नरभक्षी	नारभक्षी	pred_false
naram	नरम	नाराम	pred_false
narm	नरम	नर्म	pred_false
narmi	नरमी	नर्मी	pred_false
narsanhar	नरसंहार	नरसाहार	pred_false
narsanharon	नरसंहारों	नर्सनहरों	pred_false
november	नवंबर	नवउंबर	pred_false
navketan	नवकेतन	नवकेतन	pred_true
navjaagaran	नवजागरण	नवजाारण	pred_false
navjagran	नवजागरण	नवजाग्रण	pred_false
navdha	नवधा	नवधा	pred_true
navvadhoo	नववधू	नववाधों	pred_false
navvadhu	नववधू	नववाधु	pred_false
nava	नवा	नवा	pred_true
navaa	नवा	नवा	pred_true
navate	नवाते	नवाते	pred_true
navanagar	नवानगर	नवागर	pred_false
nawanagar	नवानगर	नवानगर	pred_true
navya	नव्या	नव्य	pred_false
naseem	नसीम	नसीम	pred_true
nasim	नसीम	नसीम	pred_true
nights	नाइट्रस	नाइट्स	pred_false
nitrous	नाइट्रस	नाइट्रॉस	pred_false
nineteez	नाइनटीज	निनीतिज	pred_false
nineties	नाइनटीज	निनीटीज	pred_false
ninties	नाइनटीज	निटीज	pred_false
nau	नाऊ	नौ	pred_false
nauu	नाऊ	नौ	pred_false
naakaam	नाकाम	नाकाम	pred_true
nakam	नाकाम	नकाम	pred_false
naagrik	नागारिक	नागरिक	pred_false
nagarik	नागारिक	नागरिक	pred_false
nagrik	नागारिक	नागरिक	pred_false
nagin	नागिन	नागीन	pred_false
nadep	नाडेप	नाडेप	pred_true
nanak	नानक	नानक	pred_true
nanavati	नानावती	नानावती	pred_true
napane	नापने	नापने	pred_true
napne	नापने	नपपने	pred_false
napa	नापा	नापा	pred_true
naam	नाम	नाम	pred_true
naamdhari	नामधारी	नामधारी	pred_true
namdhari	नामधारी	नमधारी	pred_false
namankano	नामांकनों	नामांकों	pred_false
namankanon	नामांकनों	नामकंकों	pred_false
namavaliyon	नामावलियों	नामावलियों	pred_true
naamo	नामो	नामो	pred_true
namo	नामो	नमो	pred_false
nayak	नायक	नययक	pred_false
naraji	नाराजी	नाराजी	pred_true
naraingarh	नारायणगढ़	नारींगढ़	pred_false
narayangadh	नारायणगढ़	नारायंगध	pred_false
narayangarh	नारायणगढ़	नारायंगढ़	pred_false
naasar	नासर	नासर	pred_true
nahargadh	नाहरगढ	नहरगढ़	pred_false
nahargarh	नाहरगढ	नहरगढ़	pred_false
nikalegi	निकलेगी	निकलेगी	pred_true
nikalogi	निकलेगी	निकालोगी	pred_false
nikaalani	निकालनी	निकालनी	pred_true
nikaalni	निकालनी	निकालनी	pred_true
nikalani	निकालनी	निकालनी	pred_true
nikalni	निकालनी	निकालनी	pred_true
nicki	निकी	निकी	pred_true
nicky	निकी	निकी	pred_true
niki	निकी	निकी	pred_true
niketan	निकेतन	निकेतन	pred_true
nikhar	निखर	निखर	pred_true
nikhari	निखरी	निखारी	pred_false
nigar	निगर	निगर	pred_true
nigger	निगर	नागर	pred_false
nichala	निचला	निचला	pred_true
nichalaa	निचला	निचला	pred_true
nichla	निचला	निचला	pred_true
nitiyon	नितियों	नितियों	pred_true
nitya	नित्या	नित्य	pred_false
nityaa	नित्या	नित्य	pred_false
nidhaan	निधान	निधान	pred_true
nidhan	निधान	निधन	pred_false
nipatara	निपटारा	निपटारा	pred_true
niptaara	निपटारा	निपटारा	pred_true
niptaaraa	निपटारा	निपटारा	pred_true
niptara	निपटारा	निपटारा	pred_true
niyanta	नियंता	नियंता	pred_true
niyantaa	नियंता	नियंता	pred_true
niya	निया	निया	pred_true
niyaa	निया	निया	pred_true
nirdeshika	निर्देशिका	निर्देशेशिका	pred_false
nirdeshikaa	निर्देशिका	निर्देशेकिका	pred_false
nirdhaarit	निर्धारित	निर्धारित	pred_true
nirdharit	निर्धारित	निर्धारित	pred_true
nirbaadh	निर्बाध	निर्बाध	pred_true
nirbadh	निर्बाध	निर्बाध	pred_true
niveshakartaa	निवेशकर्ता	निवेशकर्ता	pred_true
niveshkarta	निवेशकर्ता	निवेशकर्ता	pred_true
niveshkartaa	निवेशकर्ता	निवेशकर्ता	pred_true
nischal	निश्चल	निश्चल	pred_true
nishchal	निश्चल	निश्चल	pred_true
nishnaat	निष्णात	निश्नात	pred_false
nishpaap	निष्पाप	निष्पाप	pred_true
nihalaani	निहलानी	निहालनी	pred_false
nihlaani	निहलानी	निहलानी	pred_true
nihlani	निहलानी	निहलानी	pred_true
nihaalchand	निहालचंद	निहालचंद	pred_true
nihalchand	निहालचंद	निहालचंद	pred_true
neechaaee	नीचाई	नीचाई	pred_true
nichaai	नीचाई	निचाई	pred_false
neat	नीट	नीट	pred_true
neet	नीट	नीत	pred_false
neetiyon	नीतियों	नीतियों	pred_true
nitiyon	नीतियों	नितियों	pred_false
neelagaay	नीलगाय	नीलागय	pred_false
nilgai	नीलगाय	निल्गाई	pred_false
neelaabh	नीलाभ	नीलाभ	pred_true
nilaabh	नीलाभ	नीलाभ	pred_true
nilabh	नीलाभ	नीलाभ	pred_true
nuskhe	नुस्खे	नुस्खे	pred_true
noon	नून	नून	pred_true
nun	नून	नन	pred_false
noobiyaa	नूबिया	नूबिया	pred_true
nubiya	नूबिया	नुबिया	pred_false
nrityashaili	नृत्यशैली	नृत्याशाली	pred_false
nrutyashaili	नृत्यशैली	नृत्यशाली	pred_false
nrityon	नृत्यों	नृत्यों	pred_true
nrutyon	नृत्यों	नृत्यों	pred_true
neco	नेको	नेको	pred_true
neko	नेको	नेको	pred_true
nectar	नेक्टर	नेक्टर	pred_true
neg	नेग	नेग	pred_true
nega	नेग	नेगा	pred_false
networking	नेटवर्किग	नेटवर्किंग	pred_false
neto	नेटो	नेटो	pred_true
neta	नेता	नेता	pred_true
nemo	नेमो	नेमो	pred_true
nelsan	नेल्सन	नेल्सन	pred_true
nelson	नेल्सन	नेल्सन	pred_true
nations	नेशंस	नैशंस	pred_false
nehara	नेहरा	नेहरा	pred_true
nehra	नेहरा	नेहरा	pred_true
naino	नैनो	नैनो	pred_true
nano	नैनो	नानो	pred_false
naivedh	नैवेद्य	नैवेध	pred_false
naivegh	नैवेद्य	नैवेे	pred_false
nevedya	नैवेद्य	नेवेद्य	pred_false
nominate	नॉमिनेट	नॉमिनेट	pred_true
naukari	नोकरी	नौकरी	pred_false
naukri	नोकरी	नौकरी	pred_false
nokari	नोकरी	नौकरी	pred_false
nokri	नोकरी	नौकरी	pred_false
notes	नोट्स	नोट्स	pred_true
nora	नोरा	नोरा	pred_true
nori	नोरी	नोरी	pred_true
nauner	नौनेर	नौनर	pred_false
nauvahan	नौवहन	नौवहन	pred_true
naushad	नौशाद	नौषद	pred_false
panchaang	पंचांग	पंचांग	pred_true
panchang	पंचांग	पंचांग	pred_true
punchang	पंचांग	पंचाग	pred_false
punjab	पंजाब	पंजाब	pred_true
punjabiyon	पंजाबियों	पंजाबियों	pred_true
pantar	पंटर	पंतर	pred_false
panter	पंटर	पैंटर	pred_false
punter	पंटर	पंटर	pred_true
pakaayein	पकाएं	पकाएं	pred_true
pakaayen	पकाएं	पकाएं	pred_true
pakaen	पकाएं	पकाएं	pred_true
pakayen	पकाएं	पकाएं	pred_true
pakaude	पकौड़े	पकाड़	pred_false
pakshapat	पक्षपात	पक्षपात	pred_true
pakshpaat	पक्षपात	पक्षपात	pred_true
pakshpat	पक्षपात	पक्षपत	pred_false
pagabadha	पगबाधा	पगबाढ़ा	pred_false
pagbadha	पगबाधा	पगबाढ़ा	pred_false
pagalaa	पगला	पगाला	pred_false
pagla	पगला	पगला	pred_true
pachaataa	पचाता	पचाता	pred_true
pachata	पचाता	पचाता	pred_true
patakkar	पटककर	पटककर	pred_true
patkathaayein	पटकथाएं	पटकथाएं	pred_true
patkathaein	पटकथाएं	पटकथाएं	pred_true
patkathayen	पटकथाएं	पटकथाएं	pred_true
patki	पटकी	पटी	pred_false
pataraani	पटरानी	पटरनी	pred_false
patrani	पटरानी	पटरनी	pred_false
patavaari	पटवारी	पटवारी	pred_true
patwari	पटवारी	पटवारी	pred_true
pataakshep	पटाक्षेप	पटाक्षेप	pred_true
patachep	पटाक्षेप	पतचेप	pred_false
patakshep	पटाक्षेप	पट्केप	pred_false
patiya	पटिया	पटिया	pred_true
patiyaa	पटिया	पटिया	pred_true
padaraunaa	पडरौना	पदारणा	pred_false
padrauna	पडरौना	पद्रूणा	pred_false
padega	पड़ेगा	पदेगा	pred_false
padegaa	पड़ेगा	पदेगा	pred_false
padha	पढ़ा	पढ़ा	pred_true
padhaa	पढ़ा	पढ़ा	pred_true
padhaataa	पढ़ाता	पढ़ता	pred_false
padhata	पढ़ाता	पढ़ता	pred_false
patili	पतीली	पटिली	pred_false
padamawati	पदमावती	पदमावती	pred_true
padmavati	पदमावती	पद्मावती	pred_false
padmawati	पदमावती	पद्मावती	pred_false
padadhikari	पदाधिकारी	पदाधिकारी	pred_true
panapnaa	पनपना	पनपना	pred_true
panpana	पनपना	पनपाना	pred_false
panaamaa	पनामा	पनामा	pred_true
panama	पनामा	पनमा	pred_false
paneer	पनीर	पीनीर	pred_false
pammi	पम्मी	पाम्मी	pred_false
pammu	पम्मी	पामु	pred_false
pummi	पम्मी	पुम्मी	pred_false
pummy	पम्मी	पूम्मय	pred_false
pardesiyon	परदेसियों	पर्देसियों	pred_false
pardesi	परदेसी	परदेसी	pred_true
parva	परवा	पर्व	pred_false
parvaa	परवा	परवा	pred_true
parwa	परवा	परवा	pred_true
parwaa	परवा	परवा	pred_true
paraadheen	पराधीन	पराधीन	pred_true
paraadhin	पराधीन	पराधीन	pred_true
paradheen	पराधीन	पराधीन	pred_true
paradhin	पराधीन	पराधीन	pred_true
parikalpit	परिकल्पित	परिकल्पित	pred_true
parimal	परिमल	परिमाल	pred_false
parishad	परिषद	परिशाद	pred_false
parishadiy	परिषदीय	परिशादीय	pred_false
parishadiya	परिषदीय	परिशादिय	pred_false
parishadon	परिषदों	परिशादों	pred_false
parikhaen	परीक्षाएं	परीखाएं	pred_false
parikshaayein	परीक्षाएं	परीक्षाएं	pred_true
parikshaen	परीक्षाएं	परीक्षाएं	pred_true
parosane	परोसने	परोसने	pred_true
parosne	परोसने	परोसने	pred_true
parda	पर्दा	परदा	pred_false
pardaa	पर्दा	परदा	pred_false
purple	पर्पल	पुर्पल	pred_false
palatne	पलटने	पलटने	pred_true
paltane	पलटने	पल्टने	pred_false
palaari	पलारी	पलारी	pred_true
palari	पलारी	पलारी	pred_true
pale	पले	पलल	pred_false
palmonari	पल्मोनरी	पाल्नमारी	pred_false
pulmonary	पल्मोनरी	पुल्मननरी	pred_false
plus	पल्स	प्लस	pred_false
pulse	पल्स	पुलसे	pred_false
pashtun	पश्तून	पश्तुन	pred_false
pashtuun	पश्तून	पश्तुण	pred_false
pahan	पहन	पहन	pred_true
pehan	पहन	पहन	pred_true
pahantaa	पहनता	पहनता	pred_true
pahnata	पहनता	पहनता	pred_true
pehnate	पहनता	पहनाते	pred_false
pahanate	पहनते	पहनाते	pred_false
pahante	पहनते	पहनते	pred_true
pehnate	पहनते	पहनाते	pred_false
pahnaakar	पहनाकर	पहनाकर	pred_true
pahnakar	पहनाकर	पहनाकर	pred_true
pehnakar	पहनाकर	पहनाकर	pred_true
pahnaati	पहनाती	पहनाी	pred_false
pahnati	पहनाती	पहनती	pred_false
pehnati	पहनाती	पहनती	pred_false
pahani	पहनी	पहनी	pred_true
pahni	पहनी	पहनी	pred_true
pehni	पहनी	पहनी	pred_true
pahno	पहनो	पहनो	pred_true
pehno	पहनो	पहनो	pred_true
pahla	पहला	पहला	pred_true
pahlaa	पहला	पहला	pred_true
pehla	पहला	पहला	pred_true
paheliyaan	पहेलियां	पहलियां	pred_false
paheliyan	पहेलियां	पहलियां	pred_false
paheliyon	पहेलियों	पहलियों	pred_false
pide	पाइड	पीडे	pred_false
pied	पाइड	पीड	pred_false
pythagoras	पाइथागोरस	पीथगारसस	pred_false
pythogaras	पाइथागोरस	पीथगोरस	pred_false
paakhandi	पाखंडी	पाखंडी	pred_true
pakhandi	पाखंडी	पाखंडी	pred_true
paathshaalaayein	पाठशालाएं	पाठशालाएं	pred_true
pathshalayein	पाठशालाएं	पाठशालाएं	pred_true
pathshalayen	पाठशालाएं	पाठशालाएं	pred_true
paathyakram	पाठ्यक्रम	पाठ्यक्रम	pred_true
pathyakram	पाठ्यक्रम	पाठ्यक्रम	pred_true
pathykram	पाठ्यक्रम	पाठ्यक्रम	pred_true
paathyakramon	पाठ्यक्रमों	पाठ्यक्रमों	pred_true
pathyakramon	पाठ्यक्रमों	पाठ्यकरमों	pred_false
pathykramon	पाठ्यक्रमों	पाठ्यक्रमों	pred_true
population	पापुलेशन	पॉपुलेशन	pred_false
pailot	पायलट	पैलोट	pred_false
pilot	पायलट	पिलोट	pred_false
pailoton	पायलटों	पैलोटों	pred_false
piloton	पायलटों	पिलोटों	pred_false
paarampariktaa	पारंपरिकता	पारंपिकता	pred_false
paramparikata	पारंपरिकता	पारंपारिकता	pred_false
paramparikta	पारंपरिकता	पारंपिकता	pred_false
parnel	पार्नेल	परनेल	pred_false
parnell	पार्नेल	परनेल	pred_false
parleron	पार्लरों	पार्लरों	pred_true
parloron	पार्लरों	पार्लोों	pred_false
parlouron	पार्लरों	पार्लोरों	pred_false
paarshad	पार्षद	पारशाद	pred_false
parshad	पार्षद	पारशाद	pred_false
paarshadon	पार्षदों	पारशादों	pred_false
parshadon	पार्षदों	पारशादों	pred_false
parshdon	पार्षदों	पारशदों	pred_false
policy	पालिसी	पोलिसी	pred_false
pinta	पिंटा	पींटा	pred_false
pintaa	पिंटा	पिंता	pred_false
piega	पिएगा	पीएगा	pred_false
piyegaa	पिएगा	पियागा	pred_false
pic	पिक	पिक	pred_true
pick	पिक	पिक	pred_true
pik	पिक	पीक	pred_false
piki	पिकी	पीकी	pred_false
piky	पिकी	पीकी	pred_false
picture	पिक्चर	पिक्चर	pred_true
pigmentation	पिगमेंटेशन	पिगमेंटनशन	pred_false
pigs	पिग्स	पिग्स	pred_true
pichde	पिछड़े	पीछड़े	pred_false
pichhade	पिछड़े	पीछड़े	pred_false
pijja	पिज्जा	पिजजा	pred_false
pizza	पिज्जा	पिज़्जा	pred_false
pitaamaha	पितामह	पितामाहा	pred_false
pitamah	पितामह	पीतामाह	pred_false
pipra	पिपरा	पिप्र	pred_false
pipraa	पिपरा	पिप्रा	pred_false
pipli	पिपली	पिइपली	pred_false
pearson	पियरसन	पीरसों	pred_false
pierson	पियरसन	पियरसन	pred_true
peary	पियरी	पीरी	pred_false
piyari	पियरी	पियारी	pred_false
pisaai	पिसाई	पिसाई	pred_true
pisai	पिसाई	पिसाई	pred_true
pihaani	पिहानी	पिहानी	pred_true
pihani	पिहानी	पिहानी	pred_true
pib	पीआईबी	पिब	pred_false
pr	पीआर	पीआर	pred_true
pml	पीएमएल	पीएमएल	pred_true
pmo	पीएमओ	पीमो	pred_false
pmch	पीएमसीएच	पीचीएच	pred_false
psv	पीएसवी	पीसीवी	pred_false
peaking	पीकिंग	पीकिंग	pred_true
picking	पीकिंग	पिकिंग	pred_false
peetne	पीटने	पीटने	pred_true
pitne	पीटने	पिटने	pred_false
pedia	पीडिया	पेडिया	pred_false
pidiya	पीडिया	पीड़िया	pred_false
pidiyaa	पीडिया	पीड़िया	pred_false
peelepan	पीलेपन	पीलेपन	pred_true
pilepan	पीलेपन	पिलेपन	pred_false
pv	पीवी	पीवी	pred_true
pisa	पीसा	पीसा	pred_true
putla	पुतला	पुलता	pred_false
putlaa	पुतला	पुतला	pred_true
putaliyaan	पुतलियां	पुतालियां	pred_false
putliyan	पुतलियां	पुललियां	pred_false
putaliyon	पुतलियों	पुतालियों	pred_false
putliyon	पुतलियों	पुलतियों	pred_false
putali	पुतली	पुतली	pred_true
putli	पुतली	पुलली	pred_false
putale	पुतले	पुताले	pred_false
putle	पुतले	पुटल	pred_false
putin	पुतिन	पुटिन	pred_false
putul	पुतुल	पुटुल	pred_false
punargathan	पुनर्गठन	पुनर्गनाथन	pred_false
puna	पुना	पूना	pred_false
puraane	पुराने	पुराने	pred_true
purane	पुराने	पुराने	pred_true
puru	पुरू	पुरु	pred_false
purjon	पुर्जों	पूरजों	pred_false
purzon	पुर्जों	पूरजों	pred_false
pulam	पुलम	पुलाम	pred_false
pushkin	पुश्किन	पुश्किन	pred_true
pushkarana	पुष्करणा	पुष्करण	pred_false
pushkarna	पुष्करणा	पुष्करण	pred_false
pushkarnaa	पुष्करणा	पुष्करणा	pred_true
pushp	पुष्प	पुष्प	pred_true
pushpa	पुष्प	पुष्पा	pred_false
pushpa	पुष्पा	पुष्पा	pred_true
pushpaa	पुष्पा	पुष्पा	pred_true
pushpit	पुष्पित	पुष्पित	pred_true
pushpon	पुष्पों	पुष्पों	pred_true
poonjikaran	पूंजीकरण	पूंजीकरण	pred_true
punjikaran	पूंजीकरण	पंजीकरण	pred_false
poojaapaath	पूजापाठ	पूजापाठ	pred_true
poojapath	पूजापाठ	पूजपाठ	pred_false
pujapath	पूजापाठ	पूजपाठ	pred_false
pooranpur	पूरनपुर	पूरणपुर	pred_false
puranpur	पूरनपुर	पुरणपुर	pred_false
purvaabhaas	पूर्वाभास	पूर्वाभास	pred_true
purvaabhas	पूर्वाभास	पूर्वाभास	pred_true
purvabhaas	पूर्वाभास	पूर्वाभास	pred_true
purvabhas	पूर्वाभास	पूर्वास	pred_false
pendulam	पेंडुलम	पेंदुलम	pred_false
pendulum	पेंडुलम	पेंडुलम	pred_true
peg	पेग	पेग	pred_true
pages	पेजेज	पैग्स	pred_false
pajej	पेजेज	पाजेज	pred_false
pace	पेस	पेस	pred_true
pes	पेस	पेस	pred_true
pastry	पेस्ट्री	पास्ट्रीय	pred_false
pangolin	पैंगोलिन	पंगोलिन	pred_false
pengolin	पैंगोलिन	पेंगोलिन	pred_false
packard	पैकर्ड	पैकरर्ड	pred_false
package	पैकेज	पैकेज	pred_true
packageon	पैकेजों	पैकेजों	pred_true
packagon	पैकेजों	पैकाों	pred_false
packajon	पैकेजों	पक्जों	pred_false
paim	पैम	पैम	pred_true
pam	पैम	पै	pred_false
paratrooper	पैराट्रूपर	पार्तिपूर	pred_false
peratrupers	पैराट्रूपर	पेरत्रपुर्स	pred_false
paranormal	पैरानॉर्मल	परणोमाल	pred_false
peranormal	पैरानॉर्मल	पैरानमम	pred_false
paraffin	पैराफिन	पारफफिन	pred_false
parafin	पैराफिन	पाराफीन	pred_false
perafin	पैराफिन	पैराफीन	pred_false
parabola	पैराबोला	परबोला	pred_false
perabola	पैराबोला	पेराबोला	pred_false
polimer	पॉलिमर	पोलीमर	pred_false
polymer	पॉलिमर	पॉलीमर	pred_false
polishing	पॉलिशिंग	पोलीशिंग	pred_false
pokar	पोकर	पोकर	pred_true
poker	पोकर	पोकर	pred_true
polish	पोलिश	पोलिश	pred_true
poshit	पोषित	पोशित	pred_false
posta	पोस्ता	पोस्ता	pred_true
pau	पौ	पा	pred_false
pyade	प्यादे	प्याडे	pred_false
prakriya	प्रक्रिया	प्रक्रिया	pred_true
prakshepak	प्रक्षेपक	प्रक्षेपक	pred_true
pratigya	प्रतिज्ञा	प्रतिज्ञ	pred_false
prtigyaa	प्रतिज्ञा	प्रतिज्ञा	pred_true
pratibhutiyan	प्रतिभूतियां	प्रतिभूतियां	pred_true
pratiyon	प्रतियों	प्रतियों	pred_true
prativaad	प्रतिवाद	प्रतिवाद	pred_true
prativad	प्रतिवाद	प्रतिवाद	pred_true
prativadi	प्रतिवादी	प्रतिवादी	pred_true
pratishat	प्रतिशत	प्रतिष्ट	pred_false
praneet	प्रनीत	प्रणीत	pred_false
pranit	प्रनीत	प्रणित	pred_false
prapaat	प्रपात	प्रपात	pred_true
prapat	प्रपात	प्रपात	pred_true
prapaaton	प्रपातों	प्रपातों	pred_true
prapaton	प्रपातों	प्रपतों	pred_false
prabodhini	प्रबोधिनी	प्रबोधिनी	pred_true
prayaasrat	प्रयासरत	प्रयासरत	pred_true
prayasarat	प्रयासरत	प्रयासरत	pred_true
pradarshan	प्रर्दशन	प्रदर्शन	pred_false
prardashan	प्रर्दशन	प्रदर्शन	pred_false
pravati	प्रवत्ति	प्रवती	pred_false
pravatti	प्रवत्ति	प्रवत्ती	pred_false
prashaasanik	प्रशासनिक	प्रशासिक	pred_false
prashasanik	प्रशासनिक	प्रशस्निक	pred_false
prashasnik	प्रशासनिक	प्रशस्निक	pred_false
prashaasanon	प्रशासनों	प्रशासनों	pred_true
prashansanon	प्रशासनों	प्रशंसनों	pred_false
prashasanon	प्रशासनों	प्रशंसनों	pred_false
prashikshu	प्रशिक्षु	प्रशिक्षु	pred_true
prastaavon	प्रस्तावों	प्रस्तावों	pred_true
prastavon	प्रस्तावों	प्रस्तावों	pred_true
prahlaad	प्रहलाद	प्रहालाद	pred_false
prahlad	प्रहलाद	प्रहालाद	pred_false
prahasan	प्रहसन	प्रहासन	pred_false
prahsan	प्रहसन	प्रहसन	pred_true
prahaarak	प्रहारक	प्रहारक	pred_true
praharak	प्रहारक	प्रहारक	pred_true
prahad	प्रह्लाद	प्रहाद	pred_false
prahlad	प्रह्लाद	प्रहालाद	pred_false
privacy	प्राइवेसी	प्रिवासी	pred_false
praakkathan	प्राक्कथन	प्रकक्थान	pred_false
prakkathan	प्राक्कथन	प्रकक्थान	pred_false
praan	प्राण	प्राण	pred_true
pran	प्राण	प्राण	pred_true
pranon	प्राणों	प्रणों	pred_false
prathamik	प्राथमिक	प्राथमिक	pred_true
prathmik	प्राथमिक	प्राथमिक	pred_true
praathmikata	प्राथमिकता	प्राथमिकता	pred_true
prathmikta	प्राथमिकता	प्राथमिकता	pred_true
prathmiki	प्राथमिकी	प्राथमिकी	pred_true
pradhyapakon	प्राध्यापकों	प्रध्यापकों	pred_false
prapt	प्राप्त	प्राप्त	pred_true
prapta	प्राप्त	प्रपत्ता	pred_false
prapti	प्राप्ती	प्रपत्ति	pred_false
praroop	प्रारूप	प्ररूप	pred_false
prarup	प्रारूप	प्ररुप	pred_false
priyamani	प्रियामणि	प्रियमानी	pred_false
proof	प्रूफ	प्रूफ	pred_true
pruf	प्रूफ	प्रूफ	pred_true
prekshakon	प्रेक्षकों	प्रेक्षकों	pred_true
prem	प्रेम	प्रेम	pred_true
premlata	प्रेमलता	प्रेमलाता	pred_false
prema	प्रेमा	प्रेमा	pred_true
premi	प्रेमी	प्रेमी	pred_true
profit	प्रॉफिट	प्रोफिट	pred_false
processing	प्रॉसेसिंग	प्रोसेसिंग	pred_false
programers	प्रोग्रामर्स	प्रोग्रार्स	pred_false
programmers	प्रोग्रामर्स	प्रोग्रार्स	pred_false
programs	प्रोग्रामर्स	प्रोग्राम्स	pred_false
proto	प्रोटो	प्रोटो	pred_true
propellant	प्रोपेलेंट	प्रोपलेंट	pred_false
propellent	प्रोपेलेंट	प्रोपलेंट	pred_false
praudh	प्रौढ	प्रौढ़	pred_false
proud	प्रौढ	प्रोड	pred_false
plan	प्लेन	प्लान	pred_false
plane	प्लेन	प्लेने	pred_false
fund	फंड	फंड	pred_true
funda	फंडा	फूंडा	pred_false
funding	फंडिंग	फंडिंग	pred_true
fandon	फंदों	फैंडों	pred_false
fagua	फगुआ	फागुआ	pred_false
fatane	फटने	फटने	pred_true
phatane	फटने	फटने	pred_true
phatne	फटने	फटने	pred_true
fadfadata	फड़फड़ाता	फड़फ़ड़ाा	pred_false
phadphadata	फड़फड़ाता	फड़़़़़़़़ा़ा	pred_false
fatehgadh	फतेहगढ़	फटेहड़	pred_false
fatehgarh	फतेहगढ़	फटेहढ़	pred_false
fabti	फब्ती	फबबी	pred_false
phabti	फब्ती	फ़बी	pred_false
farse	फरसे	फर्स	pred_false
pharase	फरसे	फरासे	pred_false
pharse	फरसे	फर्स	pred_false
farheen	फरहीन	फरहीन	pred_true
farhin	फरहीन	फरहीन	pred_true
farth	फर्थ	फर्थ	pred_true
ferth	फर्थ	फर्थ	pred_true
pharth	फर्थ	फर्थ	pred_true
farmion	फर्मिऑन	फरमियन	pred_false
fermion	फर्मिऑन	फर्मियन	pred_false
firmian	फर्मिऑन	फर्मियन	pred_false
farookhabad	फर्रुखाबाद	फरुखाबाद	pred_false
farrukhabad	फर्रुखाबाद	फरुकाहड़	pred_false
farukhabad	फर्रुखाबाद	फरुखाबाद	pred_false
farookhnagar	फर्रूखनगर	फरुखागार	pred_false
farrukhnagar	फर्रूखनगर	फररुखगार	pred_false
farukhnagar	फर्रूखनगर	फरुखागार	pred_false
falata	फलता	फलाता	pred_false
falta	फलता	फालता	pred_false
phalata	फलता	फलता	pred_true
falne	फलने	फालने	pred_false
phalne	फलने	फलने	pred_true
falitarth	फलितार्थ	फलितार्थ	pred_true
phalitartha	फलितार्थ	फलितार्थ	pred_true
falibhoot	फलीभूत	फलीभूत	pred_true
falibhut	फलीभूत	फलीभूत	pred_true
phalibhoot	फलीभूत	फलीभूत	pred_true
favvara	फव्वारा	फावरा	pred_false
fawaara	फव्वारा	फवारा	pred_false
favvare	फव्वारे	फावरे	pred_false
fawaare	फव्वारे	फवारे	pred_false
favvaron	फव्वारों	फावरों	pred_false
fawaaron	फव्वारों	फवारों	pred_false
faisala	फ़ैसला	फैसला	pred_false
faisla	फ़ैसला	फैसला	pred_false
follow	फ़ॉलो	फोलो	pred_false
faansi	फांसी	फांसी	pred_true
fansi	फांसी	फैंसी	pred_false
fatama	फातमा	फटमा	pred_false
fatma	फातमा	फट्मा	pred_false
faaf	फाफ	फाफ	pred_true
phaaph	फाफ	फाफ	pred_true
farsi	फारसी	फर्सी	pred_false
forcee	फारसी	फोरसी	pred_false
farm	फार्म	फर्म	pred_false
form	फार्म	फॉर्म	pred_false
farmic	फार्मिक	फार्मिक	pred_true
formic	फार्मिक	फॉर्मिक	pred_false
formulae	फार्मूले	फोर्मुएलई	pred_false
formule	फार्मूले	फॉर्मूल	pred_false
formuley	फार्मूले	फॉर्मूले	pred_false
pharmacy	फार्मेसी	फर्मा्सी	pred_false
pharma	फार्मों	फर्मा	pred_false
pharmon	फार्मों	फर्मों	pred_false
farms	फार्म्स	फर्म्स	pred_false
finger	फिंगर	फाइगर	pred_false
fikra	फिक्र	फिकरा	pred_false
physician	फिजिशियन	फिसिसियां	pred_false
firti	फिरती	फिरती	pred_true
fisla	फिसला	फिस्ला	pred_false
fislaa	फिसला	फिसला	pred_true
feeder	फीडर	फीडर	pred_true
fulaaye	फुलाए	फुलाए	pred_true
fulae	फुलाए	फुलाई	pred_false
fulay	फुलाए	फुलाय	pred_false
furti	फूर्ति	फुर्ती	pred_false
phurti	फूर्ति	फूर्ती	pred_false
fus	फूस	फस	pred_false
phoos	फूस	फूस	pred_true
phus	फूस	फस	pred_false
feka	फेका	फेका	pred_true
fefada	फेफड़ा	फेफड़ा	pred_true
fefda	फेफड़ा	फेफड़ा	pred_true
facial	फेशियल	फैसियल	pred_false
fact	फैक्ट	फैक्ट	pred_true
federal	फैडरल	फेडरल	pred_false
failkar	फैलकर	फैलकर	pred_true
failaaiye	फैलाइए	फैलाए	pred_false
failaea	फैलाइए	फैलाई	pred_false
failaiya	फैलाइए	फैलाया	pred_false
failaiye	फैलाइए	फैलाए	pred_false
failegi	फैलेगी	फैलेगी	pred_true
font	फॉन्ट	फॉन्ट	pred_true
fogat	फोगाट	फोगत	pred_false
phogat	फोगाट	फोगत	pred_false
fod	फोड़	फोड	pred_false
phod	फोड़	फॉड	pred_false
foda	फोड़ा	फोडा	pred_false
fodaa	फोड़ा	फोडा	pred_false
phoda	फोड़ा	फोडा	pred_false
fode	फोड़े	फोड	pred_false
phode	फोड़े	फोडे	pred_false
fodo	फोड़ों	फोडो	pred_false
fodon	फोड़ों	फोड़ों	pred_true
phodo	फोड़ों	फोडो	pred_false
fortis	फोर्टिस	फोर्टिस	pred_true
fusion	फ्यूजन	फुसियन	pred_false
fuji	फ्यूजी	फूजी	pred_false
fyuji	फ्यूजी	फ्यूजी	pred_true
francisca	फ्रांसिस्का	फ्रांसिसा	pred_false
franciska	फ्रांसिस्का	फ्रांसिका	pred_false
fransiska	फ्रांसिस्का	फ्रांसिका	pred_false
francisco	फ्रांसिस्को	फ्रांसिस्को	pred_true
francisko	फ्रांसिस्को	फ्रांसिस्को	pred_true
fransisko	फ्रांसिस्को	फ्रांसिस्को	pred_true
fringe	फ्रिंज	फ्राइंग	pred_false
friendship	फ्रेंडशिप	फ्रींडिश्प	pred_false
frost	फ्रॉस्ट	फ्रोस्ट	pred_false
flin	फ्लिन	फ्लिन	pred_true
flynn	फ्लिन	फ्लिन	pred_true
flesh	फ्लेश	फ्लैश	pred_false
bang	बंग	बैंग	pred_false
bung	बंग	बंग	pred_true
bangbandhu	बंगबंधु	बंगबंधू	pred_false
bangbhang	बंगभंग	बंगभंग	pred_true
bangash	बंगश	बांगश	pred_false
bangsh	बंगश	बांगश	pred_false
bantane	बंटने	बंटनने	pred_false
bantne	बंटने	बंटने	pred_true
bandhati	बंधती	बांधाती	pred_false
bandhti	बंधती	बांधती	pred_false
bandhan	बंधान	बांधन	pred_false
bandhuon	बंधुओं	बंधुओं	pred_true
bamba	बंबा	बांबा	pred_false
mumba	बंबा	मुंबा	pred_false
bakaayon	बकायों	बकायों	pred_true
bakayon	बकायों	बकायों	pred_true
bakaul	बकौल	बकौल	pred_true
bakoul	बकौल	बाकूल	pred_false
baksa	बक्सा	बकसा	pred_false
baksi	बक्सी	बक्सी	pred_true
bakse	बक्से	बकसे	pred_false
bakhshane	बख्शने	बख्खने	pred_false
bakhshne	बख्शने	बख््ने	pred_false
bagad	बगड़	बागड़	pred_false
bagd	बगड़	बागड़	pred_false
bageechi	बगीची	बगीची	pred_true
bagichi	बगीची	बागीची	pred_false
bachat	बचत	बचात	pred_false
bachati	बचती	बचाती	pred_false
bachti	बचती	बच्ती	pred_false
bajana	बजना	बजना	pred_true
bajrangi	बजरंगी	बजरंगी	pred_true
bajaj	बजाज	बजाज	pred_true
batalvi	बटालवी	बटलवी	pred_false
badhachadhakar	बढ़ाचढ़ाकर	बढ़ाधकार	pred_false
badata	बढ़ाता	बड़ता	pred_false
badhaataa	बढ़ाता	बढ़ता	pred_false
badhata	बढ़ाता	बढ़ता	pred_false
badhaati	बढ़ाती	बढ़ाती	pred_true
badhati	बढ़ाती	बढ़ती	pred_false
badhayi	बढ़ायी	बढ़ाई	pred_false
badhav	बढ़ाव	बढ़ाव	pred_true
badhotari	बढ़ोतरी	बढ़ोतरी	pred_true
badhotri	बढ़ोतरी	बाधोत्री	pred_false
batlaae	बतलाए	बतलाए	pred_true
batlaaye	बतलाए	बतलाए	pred_true
batlae	बतलाए	बतलाई	pred_false
batlaye	बतलाए	बतलाए	pred_true
batlaakar	बतलाकर	बतलाकर	pred_true
batlakar	बतलाकर	बतलाकर	pred_true
badlapur	बदलापुर	बदलापुर	pred_true
badali	बदली	बदली	pred_true
badli	बदली	बदली	pred_true
badam	बदाम	बदम	pred_false
banva	बनवा	बनवा	pred_true
banvaa	बनवा	बनवा	pred_true
banaam	बनाम	बनाम	pred_true
banam	बनाम	बनाम	pred_true
bnaam	बनाम	बनाम	pred_true
baniya	बनिया	बनिया	pred_true
banu	बनू	बानू	pred_false
barpaayaa	बरपाया	बापपाया	pred_false
barpaya	बरपाया	बापपाया	pred_false
barsa	बरसा	बरसा	pred_true
barsaata	बरसाता	बरसाता	pred_true
barsaataa	बरसाता	बरसता	pred_false
barsata	बरसाता	बरसता	pred_false
barhad	बरहद	बाहड़	pred_false
baraat	बरात	बााात	pred_false
barat	बरात	बारा	pred_false
braat	बरात	ब्रात	pred_false
baraamad	बरामद	बरामद	pred_true
baramad	बरामद	बरमाद	pred_false
bramad	बरामद	ब्रमद	pred_false
baramade	बरामदे	बरमाड़े	pred_false
baramde	बरामदे	बरमदे	pred_false
bare	बरे	बारे	pred_false
birth	बर्थ	बीर्थ	pred_false
baljeet	बलजीत	बल्जीत	pred_false
baljit	बलजीत	बल्जीत	pred_false
ballabh	बल्लभ	बल्लभ	pred_true
balla	बल्ला	बल्ला	pred_true
balli	बल्ली	बल्ली	pred_true
basava	बसावा	बसा	pred_false
bastiyon	बस्तियों	बस्तियों	pred_true
bahroopiya	बहरूपिया	बहरूपीय	pred_false
bahrupiya	बहरूपिया	बहरुपीय	pred_false
bahamaas	बहामास	बहमास	pred_false
bahamas	बहामास	बहमास	pred_false
bahaav	बहाव	बहवा	pred_false
bahav	बहाव	बहव	pred_false
bhav	बहाव	भाव	pred_false
bahavalpur	बहावलपुर	बहवलपुर	pred_false
bahawalpur	बहावलपुर	बहवलपुर	pred_false
bahuchara	बहुचरा	बहुचरा	pred_true
banthia	बांठिया	बंठिया	pred_false
banthiya	बांठिया	बंथिया	pred_false
bandhate	बांधते	बांधाते	pred_false
bandhte	बांधते	बांधते	pred_true
banbi	बांबी	बांबी	pred_true
bombi	बांबी	बोंबी	pred_false
bounceron	बाउंसरों	बाउंसरों	pred_true
bowling	बाउलिंग	बोलिंग	pred_false
baku	बाकू	बाकू	pred_true
bakuu	बाकू	बाुू	pred_false
baag	बाग	बाग	pred_true
bag	बाग	बैग	pred_false
bagh	बाग	बाघ	pred_false
bagabani	बागबानी	बागबनी	pred_false
bagbani	बागबानी	बागबानी	pred_true
bagali	बागली	बगाली	pred_false
bagli	बागली	बगली	pred_false
baagiyon	बागियों	बागियों	pred_true
bagiyon	बागियों	बागियों	pred_true
baago	बागो	बागो	pred_true
bago	बागो	बागो	pred_true
baji	बाज़ी	बाजी	pred_false
bazi	बाज़ी	बाजी	pred_false
bajaru	बाजारू	बजारू	pred_false
bazaru	बाजारू	बजारू	pred_false
bajuon	बाजुओं	बाजुओं	pred_true
badh	बाध	बाध	pred_true
badha	बाधा	बाधा	pred_true
baadhaaon	बाधाओं	बाधाओं	pred_true
baadhaon	बाधाओं	बाधाओं	pred_true
badhaaon	बाधाओं	बढ़ाओं	pred_false
badhaon	बाधाओं	बढ़ाओं	pred_false
baadhit	बाधित	बाधित	pred_true
badhit	बाधित	बढ़ित	pred_false
baani	बानी	बानी	pred_true
bani	बानी	बानी	pred_true
baapa	बापा	बापा	pred_true
baapaa	बापा	बापा	pred_true
bapa	बापा	बापा	pred_true
bapaa	बापा	बपा	pred_false
baabat	बाबत	बाबत	pred_true
babat	बाबत	बबात	pred_false
babt	बाबत	बब्ट	pred_false
bayern	बायर्न	बेयर्न	pred_false
byrun	बायर्न	बायुन	pred_false
barah	बारह	बारह	pred_true
baarahamaasee	बारहमासी	बारहमासी	pred_true
barahamasi	बारहमासी	बारहमासी	pred_true
barahmasi	बारहमासी	बारहमासी	pred_true
barahsinga	बारहसिंगा	बारहसिंगा	pred_true
barasingha	बारहसिंगा	बरिसिंह	pred_false
bala	बाला	बाला	pred_true
baalti	बाल्टी	बालती	pred_false
balti	बाल्टी	बलती	pred_false
balty	बाल्टी	बाल्टी	pred_true
baldvin	बाल्डविन	बल्दवीन	pred_false
baldwin	बाल्डविन	बल्दवीन	pred_false
bavaji	बावजी	बवाजी	pred_false
bavji	बावजी	बावजी	pred_true
baawaraa	बावरा	बावरा	pred_true
bavra	बावरा	बावरा	pred_true
bawara	बावरा	बावरा	pred_true
baahulya	बाहुल्य	बाहुल्य	pred_true
bahuly	बाहुल्य	बहुल्य	pred_false
bahulya	बाहुल्य	बहुल्य	pred_false
box	बाॅक्स	बॉक्स	pred_false
bikherati	बिखेरती	बिखरती	pred_false
bikherti	बिखेरती	बिखरती	pred_false
biggest	बिगेस्ट	बाइग्सेट	pred_false
bichhua	बिछुआ	बिछुआ	pred_true
bichhuaa	बिछुआ	बिछुआ	pred_true
biji	बिजी	बीजी	pred_false
busy	बिजी	बससी	pred_false
buzy	बिजी	बुजी	pred_false
bipin	बिपिन	बीपिन	pred_false
bilae	बिलाई	बिलाए	pred_false
bilai	बिलाई	बिलाई	pred_true
billa	बिल्ला	बिल्ला	pred_true
billaa	बिल्ला	बिल्ला	pred_true
bilhaur	बिल्हौर	बिलहौर	pred_false
bisva	बिस्वा	बिस्व	pred_false
biswa	बिस्वा	बिस्व	pred_false
bag	बीएजी	बैग	pred_false
bikaner	बीकानेर	बाइकरेर	pred_false
bikaneri	बीकानेरी	बाकनेरी	pred_false
bk	बीके	बीके	pred_true
beejak	बीजक	बीजक	pred_true
bijak	बीजक	बिजक	pred_false
beef	बीफ	बीफ	pred_true
beem	बीम	बीम	pred_true
bim	बीम	बिम	pred_false
beemon	बीमों	बीमों	pred_true
bimon	बीमों	बीमों	pred_true
beerganj	बीरगंज	बीरगंज	pred_true
birganj	बीरगंज	बिरंगज	pred_false
beesavaan	बीसवां	बीसवान	pred_false
bisavan	बीसवां	बीसवान	pred_false
bisawan	बीसवां	बीसवान	pred_false
beast	बीस्ट	बेस्ट	pred_false
budvig	बुडविग	बुड़विग	pred_false
budwig	बुडविग	बुड़विग	pred_false
bull	बुल	बुल	pred_true
bulaao	बुलाओ	बुलाओ	pred_true
bulao	बुलाओ	बुलाओ	pred_true
bule	बुले	बुले	pred_true
bulletin	बुलेटिन	बुलेटीन	pred_false
brijesh	बृजेश	ब्रिजेश	pred_false
benvar	बेंवर	बेनवर	pred_false
benwar	बेंवर	बेनवर	pred_false
beaulad	बेऔलाद	बेयुडल	pred_false
bekaaboo	बेकाबू	बेकबू	pred_false
bekabu	बेकाबू	बेकबू	pred_false
bechakar	बेचकर	बेचकर	pred_true
bechkar	बेचकर	बेचकर	pred_true
bechate	बेचते	बेचते	pred_true
bechte	बेचते	बेचते	pred_true
bediyan	बेड़ियां	बेडियां	pred_false
bethanal	बेथनल	बेथनाल	pred_false
bethnal	बेथनल	बेथनाल	pred_false
benis	बेनिस	बेनिस	pred_true
belacha	बेलचा	बेलचा	pred_true
belcha	बेलचा	बेलचा	pred_true
belinda	बेलिंडा	बेलिंदा	pred_false
bevkufana	बेवकूफाना	बेकूूना	pred_false
bewakoofaanaa	बेवकूफाना	बेवकूलना	pred_false
bewkufana	बेवकूफाना	बेकूूना	pred_false
besahaaraa	बेसहारा	बेसहारा	pred_true
besahara	बेसहारा	बेसहरा	pred_false
basin	बेसिन	बसीन	pred_false
besin	बेसिन	बेसिन	pred_true
basil	बेसिल	बेसिल	pred_true
besil	बेसिल	बेसिल	pred_true
bandage	बैंडेज	बैंडेज	pred_true
bandej	बैंडेज	बंदेज	pred_false
baithantey	बैठते	बैठंते	pred_false
baithate	बैठते	बैठते	pred_true
baitool	बैतूल	बैटल	pred_false
baitul	बैतूल	बैटुल	pred_false
betul	बैतूल	बेतुल	pred_false
baini	बैनी	बैनी	pred_true
beni	बैनी	बेनी	pred_false
bairakpur	बैरकपुर	बैरकपुर	pred_true
barrackpore	बैरकपुर	बैरकपोर	pred_false
baila	बैला	बैला	pred_true
bella	बैला	बेल्ला	pred_false
ballistic	बैलिस्टिक	बल्लिस्टिक	pred_false
bells	बैल्स	बेल्स	pred_false
bostan	बॉस्टन	बोस्टन	pred_false
bosten	बॉस्टन	बोस्टन	pred_false
boston	बॉस्टन	बोस्टन	pred_false
bokaro	बोकारो	बोकरों	pred_false
bodara	बोदरा	बोदरा	pred_true
bodra	बोदरा	बोद्रा	pred_false
bodraa	बोदरा	बोद्रा	pred_false
bona	बोना	बोना	pred_true
borkar	बोरकर	बोरकर	pred_true
borivali	बोरीवली	बोरीवाली	pred_false
boriwali	बोरीवली	बोरीवाली	pred_false
born	बोर्न	बॉर्न	pred_false
bolane	बोलने	बोलने	pred_true
boliae	बोलिए	बोलियाई	pred_false
boliy	बोलिए	बोलीय	pred_false
boliye	बोलिए	बोलीय	pred_false
bosaan	बोसान	बोसान	pred_true
bosan	बोसान	बोसन	pred_false
bauni	बौनी	बौनी	pred_true
bouni	बौनी	बौनी	pred_true
byaawa	ब्यावर	ब्यावा	pred_false
byavar	ब्यावर	ब्यवर	pred_false
brajesh	ब्रजेश	ब्रजेश	pred_true
brijesh	ब्रजेश	ब्रिजेश	pred_false
brahmalin	ब्रह्मलीन	ब्रह्मालीन	pred_false
brahmleen	ब्रह्मलीन	ब्रह्मलीन	pred_true
brahmlin	ब्रह्मलीन	ब्रह्मलीन	pred_true
bravo	ब्रावो	ब्रेवो	pred_false
brigatn	ब्रिगटन	ब्रिगटन	pred_true
brighton	ब्रिगटन	ब्रिघटन	pred_false
brigton	ब्रिगटन	ब्रिट्टों	pred_false
brigadier	ब्रिगेडियर	ब्रीगाडर	pred_false
britain	ब्रिटेन	ब्रिताइन	pred_false
breed	ब्रीद	ब्रीड	pred_false
brock	ब्रोक	ब्रॉक	pred_false
brok	ब्रोक	ब्रॉक	pred_false
broke	ब्रोक	ब्रॉक	pred_false
brocken	ब्रोकन	ब्रॉकेन	pred_false
broken	ब्रोकन	ब्रोकें	pred_false
blosam	ब्लॉसम	ब्लोसमम	pred_false
blossom	ब्लॉसम	ब्लोसम	pred_false
bhagaane	भगाने	भगाने	pred_true
bhagane	भगाने	भागने	pred_false
bhadakaaya	भड़काया	भड़काया	pred_true
bhadakaya	भड़काया	भड़काया	pred_true
bhadkaayaa	भड़काया	भड़काया	pred_true
bhadkaya	भड़काया	भड़काया	pred_true
bharakaaya	भड़काया	भड़काया	pred_true
bharakaya	भड़काया	भड़कया	pred_false
bhabhoot	भभूत	भाभूत	pred_false
bhabhut	भभूत	भाभूत	pred_false
bhay	भय	भय	pred_true
bhaya	भय	भया	pred_false
bhayo	भयो	भयो	pred_true
bharatanatyam	भरतनाट्यम्	भारतनात्मयम	pred_false
bharatnatyam	भरतनाट्यम्	भारतनायतम	pred_false
bhartnatyam	भरतनाट्यम्	भर्तनात्मयम	pred_false
bharate	भरते	भरते	pred_true
bharte	भरते	भरते	pred_true
bharani	भरनी	भरणी	pred_false
bharni	भरनी	भरनी	pred_true
bharane	भरने	भरने	pred_true
bharne	भरने	भरने	pred_true
bhara	भरा	भरा	pred_true
bhavishya	भविष्य	भविष्य	pred_true
bhaate	भाते	भाते	pred_true
bhate	भाते	भाटे	pred_false
bhanu	भानू	भानु	pred_false
bhabar	भाबर	भाबर	pred_true
bhareeye	भारीय	भरीए	pred_false
bhariy	भारीय	भारिय	pred_false
bhavanaon	भावनाओं	भावनाओं	pred_true
bhavnaon	भावनाओं	भावनाओं	pred_true
bhaskar	भास्कर	भास्कर	pred_true
bheed	भीड़	भीड़	pred_true
bheera	भीरा	भीरा	pred_true
bhira	भीरा	भिरा	pred_false
bheesham	भीष्म	भीक्षम	pred_false
bhisham	भीष्म	भिक्षम	pred_false
bhishm	भीष्म	भिक्ष	pred_false
bhugat	भुगत	भुगत	pred_true
bhugata	भुगता	भुगता	pred_true
bhugta	भुगता	भुगता	pred_true
bhutto	भुट्टो	भूत्तो	pred_false
bhumi	भुमि	भूमी	pred_false
bhurbhura	भुरभुरा	भुरभूरा	pred_false
bhookh	भूख	भूख	pred_true
bhukh	भूख	भूख	pred_true
bhookhi	भूखी	भूखी	pred_true
bhukhi	भूखी	भूखी	pred_true
bhoogol	भूगोल	भूगोल	pred_true
bhugol	भूगोल	भूगोल	pred_true
bhootal	भूतल	भूतल	pred_true
bhutal	भूतल	भूतल	pred_true
bhoopsingh	भूपसिंह	भूपसिंह	pred_true
bhupsingh	भूपसिंह	भूपसिंह	pred_true
bhumi	भूमी	भूमी	pred_true
bhumika	भूमी	भूमिका	pred_false
bhulata	भूलता	भुलता	pred_false
bhulataa	भूलता	भुलता	pred_false
bhulta	भूलता	भुलता	pred_false
bhula	भूला	भुला	pred_false
bhulaa	भूला	भुला	pred_false
bhooli	भूली	भूली	pred_true
bhuli	भूली	भूली	pred_true
bhulo	भूलो	भूलो	pred_true
bhulon	भूलों	भूलों	pred_true
bhusi	भूसी	भूसी	pred_true
bhooswaami	भूस्वामी	भूस्वामी	pred_true
bhusvami	भूस्वामी	भूस्वामी	pred_true
bhuswami	भूस्वामी	भूस्वामी	pred_true
bhengapan	भेंगापन	भेंगापन	pred_true
bhairavnath	भैरवनाथ	भैरानवाथ	pred_false
bhairo	भैरो	भैरो	pred_true
bhogatey	भोगते	भोगते	pred_true
bhogte	भोगते	भोगते	pred_true
bhola	भोला	भोला	pred_true
bholi	भोली	भोली	pred_true
bholu	भोलू	भोलू	pred_true
bhaunho	भौंहों	भौनहों	pred_false
bhaunhon	भौंहों	भौनहों	pred_false
bhoonhon	भौंहों	भूनहों	pred_false
bhraant	भ्रांत	भ्रांत	pred_true
bhrant	भ्रांत	भ्रंत	pred_false
brant	भ्रांत	ब्रंट	pred_false
bhraanti	भ्रांति	भ्रांति	pred_true
bhranti	भ्रांति	भ्रंती	pred_false
branti	भ्रांति	ब्रांती	pred_false
bhraantiyan	भ्रांतियां	भ्रांतियां	pred_true
bhrantiyan	भ्रांतियां	भ्रांतियां	pred_true
bhraantiyon	भ्रांतियों	भ्रांतियों	pred_true
bhrantiyon	भ्रांतियों	भ्रांतियों	pred_true
mangesh	मंगेश	मैंगश	pred_false
manch	मंच	मांच	pred_false
manchit	मंचित	मानचित	pred_false
mancheeye	मंचीय	मनचीय	pred_false
manchiy	मंचीय	मानछय	pred_false
manchiya	मंचीय	मानचिया	pred_false
manchon	मंचों	मानों	pred_false
manjil	मंजिल	मंजिल	pred_true
manzil	मंजिल	मंजील	pred_false
manjila	मंजिला	मंजीला	pred_false
manzila	मंजिला	मंंजिला	pred_false
manjilein	मंजिलें	मंजीलें	pred_false
manjilen	मंजिलें	मंजीलें	pred_false
manzilein	मंजिलें	मंजीलें	pred_false
manto	मंटो	मांटो	pred_false
mantriyon	मंत्रियों	मंत्रियों	pred_true
makrani	मकरानी	मकरानी	pred_true
maksad	मक्सद	मकसद	pred_false
makhdumpur	मखदुमपुर	मखदमपुुर	pred_false
machaaye	मचाए	मचाए	pred_true
machae	मचाए	मचाए	pred_true
machaye	मचाए	मचाए	pred_true
machaanon	मचानों	मचानों	pred_true
machanno	मचानों	मच्ननों	pred_false
machano	मचानों	मचानो	pred_false
machanon	मचानों	मचनों	pred_false
madaura	मढ़ौरा	मदौरा	pred_false
madhuara	मढ़ौरा	मधुआरा	pred_false
madhura	मढ़ौरा	मधुरा	pred_false
manipal	मणिपाल	मनिपाल	pred_false
matpatron	मतपत्रों	मट्पत्रों	pred_false
matthe	मत्थे	मट्ठे	pred_false
matsyavatar	मत्स्यावतार	मत्स्यवत्रर	pred_false
matsyavtar	मत्स्यावतार	मत्स्यवत्र	pred_false
masyendranath	मत्स्येंद्रनाथ	मसस्येंदनाथ	pred_false
matsyendranath	मत्स्येंद्रनाथ	मैट्सींदाहन	pred_false
madhupur	मधुपुर	मधुपुर	pred_true
manmarji	मनमर्जी	मन्मराजी	pred_false
manae	मनाए	मनाए	pred_true
manaye	मनाए	मनाए	pred_true
mnaey	मनाए	मनाए	pred_true
mam	मम	माम	pred_false
mum	मम	मूम	pred_false
maryokar	मयोर्का	मारोयकर	pred_false
mayorka	मयोर्का	मेयोरका	pred_false
mayorkaa	मयोर्का	मेयोरका	pred_false
mardaani	मरदानी	मर्दानी	pred_false
mardani	मरदानी	मर्दानी	pred_false
marmar	मरमर	मरमार	pred_false
murmur	मरमर	मुरूर	pred_false
maratha	मराठा	मारठा	pred_false
marathi	मराठी	मारठी	pred_false
marji	मर्जी	मारजी	pred_false
mardanagi	मर्दानगी	मार्दागी	pred_false
mardangi	मर्दानगी	मार्दंगी	pred_false
mardo	मर्दों	मार्डो	pred_false
mardon	मर्दों	मार्डन	pred_false
maryaadaa	मर्यादा	मार्यादा	pred_false
maryada	मर्यादा	मार्याड़ा	pred_false
maryaadaaon	मर्यादाओं	मार्यादाओं	pred_false
maryadaon	मर्यादाओं	मार्यादाओं	pred_false
malaga	मलागा	मलागा	pred_true
malaar	मलार	मलार	pred_true
malar	मलार	मलार	pred_true
mashrak	मशरक	मश्रक	pred_false
masaaledaar	मसालेदार	मसेलेदार	pred_false
masaledaar	मसालेदार	मससेलादार	pred_false
masaledar	मसालेदार	मससेलेदार	pred_false
masoor	मसूर	मसूर	pred_true
masur	मसूर	मसूर	pred_true
masse	मस्से	मससे	pred_false
mahakane	महकने	महकाने	pred_false
mahakne	महकने	महकने	pred_true
mahkane	महकने	महकाने	pred_false
mehkane	महकने	मेककने	pred_false
mahalon	महलों	महलों	pred_true
mahlon	महलों	महलों	pred_true
mahagranth	महाग्रंथ	महारंथ	pred_false
mhagranth	महाग्रंथ	महाग्राथ	pred_false
mahajan	महाजन	महजन	pred_false
mhajan	महाजन	महाजन	pred_true
mahathir	महाथिर	महातिर	pred_false
mhathir	महाथिर	महातिर	pred_false
mahanatam	महानतम	महनतम	pred_false
mahantam	महानतम	महंतम	pred_false
mhantam	महानतम	महनतम	pred_false
mahanideshak	महानिदेशक	महानिदेशक	pred_true
mahanirdeshak	महानिदेशक	महनिर्देशक	pred_false
mhanideshak	महानिदेशक	महानिदेशक	pred_true
mahapauron	महापौरों	महापौरों	pred_true
mhapauron	महापौरों	महापोरों	pred_false
mahapran	महाप्राण	महप्रण	pred_false
mhapran	महाप्राण	महाप्रण	pred_false
mahamantr	महामंत्र	महामंत्र	pred_true
mahamantra	महामंत्र	महमतंत्र	pred_false
mhamantra	महामंत्र	महामंत्र	pred_true
maharaja	महाराजा	महराजा	pred_false
mahavigyan	महाविज्ञान	महाविज्ञान	pred_true
mhavidyan	महाविज्ञान	महाविद्यान	pred_false
mahavidya	महाविद्या	महाविद्य	pred_false
mhavidya	महाविद्या	महाविद्य	pred_false
mahavishnu	महाविष्णु	महाविश्णु	pred_false
mahasingh	महासिंह	महासिंह	pred_true
mahasinh	महासिंह	महासिंह	pred_true
mahipal	महिपाल	महिपाल	pred_true
mahin	महीन	महीन	pred_true
mahinon	महीनों	महीनों	pred_true
maang	मांग	मांग	pred_true
mang	मांग	मांग	pred_true
mangani	मांगनी	मंगनी	pred_false
mangni	मांगनी	मांगनी	pred_true
maanga	मांगा	मांगा	pred_true
manga	मांगा	मंगा	pred_false
maangi	मांगी	मांगी	pred_true
mangi	मांगी	मांगी	pred_true
maange	मांगे	मांगे	pred_true
mange	मांगे	मंगे	pred_false
mango	मांगो	मंगो	pred_false
maori	माओरी	मारी	pred_false
maajin	माजिन	माजीन	pred_false
majin	माजिन	मजीन	pred_false
mathe	माथे	मठे	pred_false
mathey	माथे	मैठे	pred_false
maap	माप	माप	pred_true
map	माप	मैप	pred_false
mop	माप	मोप	pred_false
mamooli	मामूली	ममूली	pred_false
mamuli	मामूली	मामूली	pred_true
mame	मामे	मेम	pred_false
maarvaad	मारवाड़	मारवाद	pred_false
marvad	मारवाड़	मार्वाद	pred_false
marwar	मारवाड़	मारवर	pred_false
maariya	मारिया	मारिया	pred_true
mariya	मारिया	मारिया	pred_true
maariyo	मारियो	मारियो	pred_true
mario	मारियो	मारियो	pred_true
mariyo	मारियो	मारियो	pred_true
martha	मार्था	मार्थ	pred_false
maalish	मालिश	मालीश	pred_false
malish	मालिश	मालीश	pred_false
mave	मावे	मेव	pred_false
mavey	मावे	मेवे	pred_false
maas	मास	मास	pred_true
mas	मास	मस	pred_false
mass	मास	मसस	pred_false
maason	मासों	मासों	pred_true
mason	मासों	मसों	pred_false
mitaao	मिटाओ	मिटाओ	pred_true
mitao	मिटाओ	मिटाओ	pred_true
mithaai	मिठाई	मिथाई	pred_false
mithai	मिठाई	मिथाई	pred_false
media	मिडिया	मेडिया	pred_false
mithila	मिथिला	मिथिला	pred_true
mithilanchal	मिथिलांचल	मिथिलंचल	pred_false
mithya	मिथ्या	मिठ्य	pred_false
mimicry	मिमिक्री	माइक्री	pred_false
milkiyat	मिल्कियत	मिल्कियत	pred_true
misha	मिशा	मिशा	pred_true
mungeri	मुंगेरी	मुंगेरी	pred_true
mundva	मुंडवा	मुंडडवा	pred_false
mundwa	मुंडवा	मुंडवा	pred_true
munshiganj	मुंशीगंज	मुंशिंग	pred_false
mukarte	मुकरते	मुकरते	pred_true
mukartey	मुकरते	मुकरते	pred_true
mukhopadhyaya	मुखोपाध्याय	मुखोपाध्याय	pred_true
mukhyopadhyaay	मुखोपाध्याय	मुख्योपाध्याय	pred_false
mukhyamantri	मुख्यमंत्री	मुख्यमंत्री	pred_true
munaf	मुनाफ	मुनाफ	pred_true
munafa	मुनाफा	मुनाफा	pred_true
munnu	मुन्नू	मुनू	pred_false
mufalisi	मुफलिसी	मुफलीसी	pred_false
muflisi	मुफलिसी	मुफलीसी	pred_false
mubarakpur	मुबारकपुर	मुबारकपुर	pred_true
mubarkpur	मुबारकपुर	मुबारकपुर	pred_true
murjha	मुर्झा	मुरझा	pred_false
multae	मुल्ताई	मुल्ताए	pred_false
multai	मुल्ताई	मुल्ताई	pred_true
mushahid	मुशाहिद	मुशहदिद	pred_false
muhavare	मुहावरे	मुहावरे	pred_true
muhavre	मुहावरे	मुहावरे	pred_true
mooth	मूठ	मूथ	pred_false
muth	मूठ	मूथ	pred_false
mood	मूड	मूद	pred_false
mud	मूड	मुड़	pred_false
moodi	मूडी	मूदी	pred_false
moody	मूडी	मूद्य	pred_false
mool	मूल	मूल	pred_true
mul	मूल	मूल	pred_true
moolchand	मूलचंद	मूलचंद	pred_true
mulchand	मूलचंद	मुलचंद	pred_false
moolar	मूलर	मूलर	pred_true
mular	मूलर	मूलर	pred_true
muller	मूलर	मललर	pred_false
moolon	मूलों	मूलों	pred_true
mulon	मूलों	मूलों	pred_true
maxico	मेक्सिको	मैक्सिको	pred_false
mexico	मेक्सिको	मैक्सिको	pred_false
mega	मेगा	मेगा	pred_true
megapixal	मेगापिक्सल	मैग्पिकल	pred_false
megapixel	मेगापिक्सल	मैग्पेक्स	pred_false
mejbaan	मेजबान	मेबबान	pred_false
mejban	मेजबान	मेजबन	pred_false
mezbaan	मेजबान	मेबबान	pred_false
mejabani	मेजबानी	मेजबानी	pred_true
mejbaani	मेजबानी	मेबबानी	pred_false
mejbani	मेजबानी	मेबबानी	pred_false
mezabani	मेजबानी	मेजबानी	pred_true
mejbaan	मेज़बान	मेबबान	pred_false
mejban	मेज़बान	मेजबन	pred_false
mezbaan	मेज़बान	मेबबान	pred_false
mejbaani	मेज़बानी	मेबबानी	pred_false
mejbani	मेज़बानी	मेबबानी	pred_false
mezbaani	मेज़बानी	मेबबानी	pred_false
mate	मेट	मैट	pred_false
met	मेट	मेट	pred_true
mates	मेट्स	मैट्स	pred_false
medical	मेडीकल	मेडिकल	pred_false
methanol	मेथेनॉल	मैथननल	pred_false
menu	मेनू	मेनू	pred_true
mem	मेम	मेम	pred_true
melaghaat	मेलघाट	मेलाघाट	pred_false
melghat	मेलघाट	मेलघाट	pred_true
melaanin	मेलानिन	मेलानि	pred_false
melanin	मेलानिन	मेलानि	pred_false
melaani	मेलानी	मेलानी	pred_true
melani	मेलानी	मेलनी	pred_false
maheman	मेहमान	महेमन	pred_false
mehamaan	मेहमान	मेहमान	pred_true
mehaman	मेहमान	मेहमान	pred_true
mehmaan	मेहमान	मेहमान	pred_true
mehman	मेहमान	मेहमन	pred_false
meharaam	मेहराम	मेहराम	pred_true
mehram	मेहराम	मेहराम	pred_true
macbook	मैकबुक	मैकबुक	pred_true
matix	मैट्रिक्स	मैटिक्स	pred_false
matrix	मैट्रिक्स	मेट्रिक्स	pred_false
mad	मैड	माद	pred_false
made	मैड	मैड	pred_true
maid	मैड	मैड	pred_true
maddy	मैडी	मद्डी	pred_false
maidi	मैडी	मैदी	pred_false
main	मैन	मैन	pred_true
man	मैन	मन	pred_false
men	मैन	मेन	pred_false
mainan	मैनन	मैनन	pred_true
menon	मैनन	मेनों	pred_false
manner	मैनर	मानर	pred_false
maina	मैना	मैना	pred_true
maine	मैने	मैने	pred_true
marrej	मैरेज	मैरेज	pred_true
marriage	मैरेज	मैरिज	pred_false
merraige	मैरेज	मेरेज	pred_false
maisachusets	मैसाचुसेट्स	मैसाचुस्ट्स	pred_false
massachusetts	मैसाचुसेट्स	मैस्चास्टेंट्स	pred_false
maisor	मैसोर	मैसर	pred_false
maisore	मैसोर	मैसोर	pred_true
mysore	मैसोर	मैसूर	pred_false
mod	मॉड	मोड़	pred_false
mode	मॉड	मोड	pred_false
modern	मॉडर्न	मॉडरन	pred_false
module	मॉड्यूल	मोडुले	pred_false
modules	मॉड्यूल्स	मोडल्स	pred_false
modyuls	मॉड्यूल्स	मोडियल्स	pred_false
mauritious	मॉरिशस	मॉरिशिस	pred_false
mauritius	मॉरिशस	मॉरीशिस	pred_false
mogali	मोगली	मोगली	pred_true
mowgli	मोगली	मोगली	pred_true
motive	मोटिव	मोटिव	pred_true
mol	मोल	मॉल	pred_false
mold	मोल्ड	मॉल्ड	pred_false
moshe	मोशे	मोशे	pred_true
mosad	मोसाद	मोसाद	pred_true
mohana	मोहाना	मोहना	pred_false
mohani	मोहानी	मोहनी	pred_false
mohini	मोहिनी	मोहिनी	pred_true
mohim	मोहिम	मोहिम	pred_true
maukon	मौकों	मौकों	pred_true
mauma	मौमा	मौमा	pred_true
maurya	मौर्या	मौर्य	pred_false
morya	मौर्या	मोरिया	pred_false
maurya	मौर्यों	मौर्य	pred_false
mauryon	मौर्यों	मॉर्यों	pred_false
moryon	मौर्यों	मोरियों	pred_false
maulaviyon	मौलवियों	मौलवियों	pred_true
maulvidon	मौलवियों	मौलविदों	pred_false
maulviyon	मौलवियों	मौलवियों	pred_true
maule	मौले	मौले	pred_true
mauley	मौले	मौले	pred_true
mausa	मौसा	मौसा	pred_true
yatn	यत्न	यतन	pred_false
yatna	यत्न	यतना	pred_false
yada	यदा	यादा	pred_false
yda	यदा	एाडा	pred_false
yaduvansh	यदुवंश	यादुवंश	pred_false
yaduwansh	यदुवंश	यादुवाश	pred_false
jerusalem	यरूशलेम	जेरूस्लम	pred_false
yarooshaleim	यरूशलेम	यारुशकलल	pred_false
yarushalem	यरूशलेम	युरुशेलम	pred_false
yashpaal	यशपाल	यशपाल	pred_true
yashpal	यशपाल	यश्पाल	pred_false
yaatna	यातना	यातना	pred_true
yatna	यातना	यतना	pred_false
yaatanaon	यातनाओं	यतनाओं	pred_false
yatnaon	यातनाओं	यतनाओं	pred_false
yarayan	यात्राएं	याायण	pred_false
yatraein	यात्राएं	यात्राएं	pred_true
yatraen	यात्राएं	यात्राएं	pred_true
yaariyan	यारियां	यारियां	pred_true
yariyan	यारियां	यारियां	pred_true
yaari	यारी	यारी	pred_true
yari	यारी	यारी	pred_true
yugam	युग्म	युगम	pred_false
yugm	युग्म	युगम	pred_false
yuddhrat	युद्धरत	युद्धतरत	pred_false
yudhrat	युद्धरत	युद्धात	pred_false
ukrainian	यूक्रेनियन	यूक्रेनियन	pred_true
ukranian	यूक्रेनियन	यूक्रिणा	pred_false
jerusalem	येरुशलम	जेरूस्लम	pred_false
yorker	यॉर्कर	यॉकरेर	pred_false
yojanaein	योजनाएं	योजनाएं	pred_true
yojanaen	योजनाएं	योजनाएं	pred_true
yojanaye	योजनाएं	योजनाए	pred_false
rangate	रंगते	रंगते	pred_true
rangte	रंगते	रंगते	pred_true
rangkata	रंजकता	रंगकता	pred_false
ranjkatha	रंजकता	रंजकाठा	pred_false
ranjkta	रंजकता	रंजकता	pred_true
raees	रईस	रैस	pred_false
rais	रईस	रैस	pred_false
raktaabh	रक्ताभ	रक्ताभ	pred_true
raktabh	रक्ताभ	रक्तभ	pred_false
rakhna	रखना	रखना	pred_true
raghupati	रघुपति	रघुपती	pred_false
raghuram	रघुराम	रघुराम	pred_true
registerd	रजिस्टर्ड	रजिस्टेेड	pred_false
registered	रजिस्टर्ड	रजिस्टेेड्ड	pred_false
ratanpur	रतनपुर	रतनपुर	pred_true
runners	रनर्स	रणर्स	pred_false
rayan	रयान	रायन	pred_false
ryan	रयान	रियान	pred_false
ralhan	रल्हन	राहन	pred_false
ravish	रविश	रािश	pred_false
ravael	रवैल	रवैल	pred_true
ravel	रवैल	रेवल	pred_false
rawail	रवैल	रवैल	pred_true
rasad	रसद	रसाद	pred_false
rasaayanik	रसायनिक	रसायिक	pred_false
rasaayanika	रसायनिक	रसायिका	pred_false
rasayanika	रसायनिक	रसायिका	pred_false
rasyanik	रसायनिक	रास्यानिक	pred_false
rasaayanon	रसायनों	रसायनों	pred_true
rasayanon	रसायनों	रसायनों	pred_true
rahamat	रहमत	रहमत	pred_true
rahmat	रहमत	रहमत	pred_true
rhamat	रहमत	रहमत	pred_true
rahenge	रहेंगे	रेंगे	pred_false
rahegi	रहेगी	रहेगी	pred_true
rounder	राउंडर	राउंडर	pred_true
raak	राक	राक	pred_true
rak	राक	रक	pred_false
raakhe	राखे	राखे	pred_true
rakhe	राखे	रखे	pred_false
raagon	रागों	रागों	pred_true
ragon	रागों	रागों	pred_true
raghavan	राघवन	रघवान	pred_false
raaj	राज	राज	pred_true
raj	राज	राज	pred_true
rajkot	राजकोट	राजकोट	pred_true
rajtantra	राजतंत्र	राजतंत्र	pred_true
raajneetikaran	राजनीतीकरण	राजनीतकरण	pred_false
rajneetikaran	राजनीतीकरण	राजनीतकरण	pred_false
rajnitikaran	राजनीतीकरण	राजनीतकरण	pred_false
rajma	राजमां	राजमा	pred_false
rajman	राजमां	राजमान	pred_false
raajasva	राजस्व	राजस्व	pred_true
rajasva	राजस्व	राजसवा	pred_false
raaji	राजी	राजी	pred_true
raji	राजी	राजी	pred_true
rajinaama	राजीनामा	राजीनामा	pred_true
rajinama	राजीनामा	राजीनामा	pred_true
raajon	राजों	राजों	pred_true
rajon	राजों	राजों	pred_true
rana	राणा	राना	pred_false
raatrichar	रात्रिचर	रात्रिचिर	pred_false
ratrichar	रात्रिचर	रात्चिचर	pred_false
raadhe	राधे	राढ़े	pred_false
radhe	राधे	राढ़े	pred_false
ranapur	रानापुर	रणनपुर	pred_false
rabin	राबिन	रबीन	pred_false
robin	राबिन	रॉबिन	pred_false
rabha	राभा	रभा	pred_false
ramkot	रामकोट	रामकट	pred_false
ramkote	रामकोट	रामकोट	pred_true
ramtek	रामटेक	रामेटक	pred_false
rampur	रामपुर	रामपुर	pred_true
rambharose	रामभरोसे	रामभरोस	pred_false
rambharosey	रामभरोसे	रामभर्से	pred_false
ramraj	रामराज	रामराज	pred_true
raalod	रालोद	रालोड	pred_false
ralaud	रालोद	रालाउड	pred_false
ralod	रालोद	रालोड	pred_false
ravaley	रावले	रावले	pred_true
ravle	रावले	रावले	pred_true
rasayanik	रासायनिक	रसायिक	pred_false
racreation	रिक्रिएशन	रैक्रेशन	pred_false
recreation	रिक्रिएशन	रिक्रेशन	pred_false
rig	रिग	रिग	pred_true
riggs	रिग्स	रिग्स	pred_true
rigs	रिग्स	रिग्स	pred_true
richual	रिचुअल	रिचुल	pred_false
ritual	रिचुअल	रितुअल	pred_false
reduction	रिडक्शन	रिडुक्शन	pred_false
ripan	रिपन	रिपान	pred_false
ripon	रिपन	रिपों	pred_false
ria	रिया	रिया	pred_true
riya	रिया	रिया	pred_true
rishte	रिश्ते	रिश्ते	pred_true
rishtey	रिश्ते	रिश्ते	pred_true
risane	रिसने	रिसने	pred_true
risaney	रिसने	रिसने	pred_true
risne	रिसने	रिसने	pred_true
rihana	रिहाना	रिहना	pred_false
rihanna	रिहाना	रिहन्ना	pred_false
regal	रीगल	रिगल	pred_false
rigal	रीगल	रिगल	pred_false
reasonal	रीजनल	रीजोन	pred_false
regional	रीजनल	रिजोनल	pred_false
retreate	रीट्वीट	रेट्रेट	pred_false
retweet	रीट्वीट	रिटवीट	pred_false
reeta	रीता	रीता	pred_true
rita	रीता	रीता	pred_true
rukate	रुकते	रुकते	pred_true
rukte	रुकते	रुकते	pred_true
ruktey	रुकते	रुकते	pred_true
rugan	रुग्ण	रुगण	pred_false
rugna	रुग्ण	रूगना	pred_false
ruganta	रुग्णता	रुगांता	pred_false
rugnata	रुग्णता	रूगना	pred_false
rojvelt	रुजवेल्ट	रोजवेल्ट	pred_false
roojwelt	रुजवेल्ट	रूजवेल्ट	pred_false
roosevelt	रुजवेल्ट	रूज़वेल्ट	pred_false
rodolph	रुडोल्फ	रोडोल्फ	pred_false
rudolf	रुडोल्फ	रूडोल्फ	pred_false
rudolph	रुडोल्फ	रूडोल्फ	pred_false
roopesh	रुपेश	रुपेश	pred_true
rupesh	रुपेश	रुपेश	pred_true
ruby	रुबी	रूबी	pred_false
roomani	रुमानी	रूमानी	pred_false
rumani	रुमानी	रूमानी	pred_false
rukavaton	रूकावटों	रुकावटों	pred_false
root	रूट	रुत	pred_false
route	रूट	राउत	pred_false
rooting	रूटिंग	रूटिंग	pred_true
routine	रूटिंग	राउटिन	pred_false
routing	रूटिंग	राउटिंग	pred_false
roots	रूट्स	रुत्स	pred_false
routes	रूट्स	राउट्स	pred_false
roopak	रूपक	रुपक	pred_false
rupak	रूपक	रुपक	pred_false
roopi	रूपी	रुपी	pred_false
rupi	रूपी	रुपी	pred_false
rantle	रेंटल	रंंल	pred_false
rental	रेंटल	रेंटल	pred_true
registan	रेगिस्तान	रेजिस्टान	pred_false
registani	रेगिस्तानी	रेजिस्टानी	pred_false
reja	रेजा	रेजा	pred_true
reza	रेजा	रेजा	pred_true
rate	रेट	राट	pred_false
rate	रेत	राट	pred_false
ret	रेत	रेट	pred_false
refaeli	रेफेली	रेफाली	pred_false
refeli	रेफेली	रेफलली	pred_false
reshe	रेशे	रेशे	pred_true
reshey	रेशे	रेशे	pred_true
race	रेस	रेस	pred_true
rese	रेस	रेस	pred_true
racer	रेसर	रेसर	pred_true
recer	रेसर	रिसर	pred_false
racing	रेसिंग	रेसिंग	pred_true
reson	रेसों	रेसों	pred_true
rehaana	रेहाना	रेहाना	pred_true
rehana	रेहाना	रेहना	pred_false
racketeer	रैकेटियर	रैकेटिर	pred_false
racketier	रैकेटियर	रैकेटियर	pred_true
rectare	रैकेटियर	रिक्टेयर	pred_false
radical	रैडिकल	रेडिकल	pred_false
raidical	रैडिकल	रैडिकल	pred_true
raith	रैथ	रैठ	pred_false
rapping	रैपिंग	रैपिंग	pred_true
wrapping	रैपिंग	वैप्रिंग	pred_false
robertsan	रॉबर्टसन	रॉबर्टनसन	pred_false
robertson	रॉबर्टसन	रॉबर्टन	pred_false
robinson	रॉबिंसन	रॉबिंसन	pred_true
royals	रॉयल्स	रॉयल्स	pred_true
rojlin	रोजलिन	रोजलिन	pred_true
rozlyn	रोजलिन	रोजलिन	pred_true
rotation	रोटेशन	रोटेशन	pred_true
rodrigo	रोड्रिगो	रोड्रिगो	pred_true
ronaldo	रोनाल्डो	रोनाल्डो	pred_true
ronit	रोनित	रोनिट	pred_false
roni	रोनी	रोनी	pred_true
ropane	रोपने	रोपने	pred_true
ropaney	रोपने	रोपने	pred_true
ropne	रोपने	रोपने	pred_true
robin	रोबिन	रॉबिन	pred_false
roya	रोया	रॉया	pred_false
rollers	रोलर्स	रॉलर्स	pred_false
rovan	रोवन	रववान	pred_false
rowan	रोवन	रावन	pred_false
rosario	रोसारियो	रोसररियो	pred_false
rosariyo	रोसारियो	रोसरियो	pred_false
raubadaar	रौबदार	रौबदार	pred_true
raubadar	रौबदार	रौबदार	pred_true
raubdar	रौबदार	रौबदार	pred_true
landara	लंगड़ा	लांडड़ा	pred_false
langada	लंगड़ा	लंगड़ा	pred_true
langda	लंगड़ा	लांगड़ा	pred_false
langar	लंगर	लंगार	pred_false
langaron	लंगरों	लंगारों	pred_false
langron	लंगरों	लैंगरों	pred_false
lambi	लंबी	लांबी	pred_false
lakeer	लकीर	लेकीर	pred_false
lakir	लकीर	लाकिर	pred_false
lakiron	लकीरों	लकीरों	pred_true
lakme	लक्मे	लक्मे	pred_true
lakshmidhar	लक्ष्मीधर	लक्ष्मीधार	pred_false
lakshmighar	लक्ष्मीधर	लक्ष्मीघर	pred_false
lakshy	लक्ष्य	लक्ष्य	pred_true
lakshya	लक्ष्य	लक्ष्य	pred_true
lakshyon	लक्ष्यों	लक्ष्यों	pred_true
lux	लक्स	लक्स	pred_true
laksar	लक्सर	लक्सर	pred_true
luxor	लक्सर	लककर	pred_false
lakhkhi	लख्खी	लख्खी	pred_true
lagna	लगना	लगना	pred_true
laganewale	लगनेवाले	लगनेवाले	pred_true
lagnevaaley	लगनेवाले	लगनेवाले	pred_true
lagnewale	लगनेवाले	लैनेवाले	pred_false
lagega	लगेगा	लगेगा	pred_true
lajjalu	लज्जालु	लजजालू	pred_false
latkate	लटकाते	लटकते	pred_false
ladki	लड़की	लड़की	pred_true
ladate	लड़ते	लाड़ते	pred_false
ladte	लड़ते	लड़ते	pred_true
ladaai	लड़ाई	लड़ाई	pred_true
ladai	लड़ाई	लड़ाई	pred_true
ladaaiyon	लड़ाईयों	लड़ाइयों	pred_false
ladaeyon	लड़ाईयों	लड़ाएयों	pred_false
ladaiyon	लड़ाईयों	लड़ाइयों	pred_false
lapetane	लपेटने	लपेटने	pred_true
lapetne	लपेटने	लपपेटन	pred_false
labada	लबादा	लाबड़ा	pred_false
lbada	लबादा	ललाड़ा	pred_false
labdh	लब्ध	लाब्ध	pred_false
lbdh	लब्ध	लल्ब	pred_false
lalak	ललक	लालक	pred_false
lalkarata	ललकारता	लाकररता	pred_false
lalkarta	ललकारता	लाकर्ता	pred_false
lalla	लल्ला	लाला	pred_false
lavasa	लवासा	लवासा	pred_true
lovasa	लवासा	लववासा	pred_false
lassi	लस्सी	लासी	pred_false
lahanaa	लहना	लहना	pred_true
lahna	लहना	लहना	pred_true
lehna	लहना	लेना	pred_false
lahraee	लहराई	लहराई	pred_true
lahrai	लहराई	लहराई	pred_true
lehrayi	लहराई	लहरायी	pred_false
lahalhati	लहलहाती	लहलालती	pred_false
lahlahaati	लहलहाती	लहलाहाटी	pred_false
lahlahati	लहलहाती	लहलाहटी	pred_false
lahsun	लहसुन	लहसून	pred_false
lasoon	लहसुन	लासून	pred_false
lanchar	लांचर	लांचार	pred_false
launcher	लांचर	लॉन्चर	pred_false
lycopene	लाइकोपिन	लाइपोन	pred_false
lime	लाइम	लाइम	pred_true
lives	लाइव्स	लाइव्स	pred_true
live	लाईव	लाइव	pred_false
laegi	लाएगी	लाएगी	pred_true
lagataar	लागातार	लगातर	pred_false
lagatar	लागातार	लगातर	pred_false
laata	लाता	लाता	pred_true
lata	लाता	लता	pred_false
laati	लाती	लाती	pred_true
lati	लाती	लटी	pred_false
layega	लायेगा	लायेगा	pred_true
lalpur	लालपुर	लालपुर	pred_true
las	लास्ट	लास	pred_false
last	लास्ट	लास्त	pred_false
lindbhed	लिंगभेद	लिंडभेड	pred_false
lingbhed	लिंगभेद	लिंगभेड	pred_false
lindan	लिंडन	लिंदन	pred_false
lindn	लिंडन	लिंडन	pred_true
lindon	लिंडन	लिंडन	pred_true
likhakar	लिखकर	लिखाकर	pred_false
likhkar	लिखकर	लिखकर	pred_true
ligar	लिगर	लिगर	pred_true
liger	लिगर	लाइजर	pred_false
liberation	लिबरेशन	लाइब्रेशन	pred_false
libration	लिबरेशन	लाइब्रेशन	pred_false
liberation	लिब्रेशन	लाइब्रेशन	pred_false
libration	लिब्रेशन	लाइब्रेशन	pred_false
leaderon	लीडरों	लीडरों	pred_true
leedaron	लीडरों	लीडारों	pred_false
lidaron	लीडरों	लिडारों	pred_false
liidaron	लीडरों	लिडारों	pred_false
louis	लुईस	लाइस	pred_false
luis	लुईस	लुई	pred_false
ludhakate	लुढ़कते	लुढ़कते	pred_true
ludhkate	लुढ़कते	लुढ़कते	pred_true
lurhakate	लुढ़कते	लुढ़कते	pred_true
lutf	लुत्फ	लुटफ	pred_false
lumding	लुमडिंग	लुमिंग	pred_false
lootmaar	लूटमार	लूटमार	pred_true
lootmar	लूटमार	लूटमार	pred_true
landal	लेंडल	लैंडल	pred_false
lendal	लेंडल	लेनडल	pred_false
lega	लेगा	लेगा	pred_true
legaa	लेगा	लेगा	pred_true
letakar	लेटकर	लेटकर	pred_true
letkar	लेटकर	लेटकर	pred_true
lenevali	लेनेवाली	लेनेवाली	pred_true
lenewali	लेनेवाली	लेनेवाली	pred_true
label	लेबल	लेबल	pred_true
labeling	लेबलिंग	लेबेलिंग	pred_false
labelling	लेबलिंग	लेबलिंग	pred_true
labelo	लेबलों	लेबलो	pred_false
labelon	लेबलों	लेबलों	pred_true
lebalon	लेबलों	लेबबों	pred_false
lemon	लेमन	लेमोन	pred_false
laingadan	लैंगडन	लैंगड़न	pred_false
langdon	लैंगडन	लैंडडों	pred_false
lengdan	लैंगडन	लेंगडन	pred_false
laigikata	लैंगिकता	लैगिकता	pred_false
laingikta	लैंगिकता	लैंगिकता	pred_true
lanset	लैंसेट	लैंसेट	pred_true
lenset	लैंसेट	लेनसेट	pred_false
lairi	लैरी	लैरी	pred_true
lairy	लैरी	लैयरी	pred_false
larry	लैरी	लारी	pred_false
lace	लैस	लेस	pred_false
less	लैस	लेस	pred_false
locket	लॉकेट	लॉकेट	pred_true
laundry	लॉन्ड्री	लौनड्री	pred_false
longewal	लोंगोवाल	लोनेेवाल	pred_false
longewala	लोंगोवाल	लोंगेवाला	pred_false
longoval	लोंगोवाल	लोनगवाल	pred_false
log	लोग	लॉग	pred_false
loge	लोगे	लोज	pred_false
lochdar	लोचदार	लोचड़र	pred_false
lodi	लोदी	लोडी	pred_false
laurence	लौरेंस	लारेंस	pred_false
laurens	लौरेंस	लारेंस	pred_false
laurense	लौरेंस	लारेंस	pred_false
wonder	वंडर	वंडर	pred_true
vansh	वंश	वंश	pred_true
vanshdhar	वंशधर	वंशधर	pred_true
vanshavad	वंशवाद	वंशावाद	pred_false
vanshvaad	वंशवाद	वंश्वाद	pred_false
vanshvad	वंशवाद	वंश्वाद	pred_false
wanshwad	वंशवाद	वंश्वाद	pred_false
vajood	वजूद	वजूद	pred_true
vajud	वजूद	वजूद	pred_true
wajood	वजूद	वजूद	pred_true
vadali	वडाली	वादली	pred_false
vadli	वडाली	वादली	pred_false
wadali	वडाली	वादली	pred_false
vanita	वनिता	वनीता	pred_false
vareinye	वरेण्य	वेरेन्य	pred_false
varenya	वरेण्य	वेरेनिया	pred_false
varn	वर्ण	वॉर्न	pred_false
varna	वर्ण	वरना	pred_false
varnit	वर्णित	वार्नित	pred_false
vartamaan	वर्तमान	वर्तमान	pred_true
vartaman	वर्तमान	वर्तमान	pred_true
vartmaan	वर्तमान	वर्तमान	pred_true
vartman	वर्तमान	वर्तमान	pred_true
varddhaman	वर्द्धमान	वर्द्धमान	pred_true
vardhmaan	वर्द्धमान	वर्धमान	pred_false
vardhman	वर्द्धमान	वर्धमान	pred_false
verbal	वर्बल	वेरबल	pred_false
varshan	वर्शन	वर्ष्ण	pred_false
vasharan	वर्शन	वाशरण	pred_false
vershan	वर्शन	वेर्ष्ण	pred_false
version	वर्शन	वर्सिन	pred_false
varsaache	वर्साचे	वर्साचे	pred_true
varsaryache	वर्साचे	वर्ससाराय	pred_false
vasearche	वर्साचे	वससरेच	pred_false
valkan	वल्कन	वाल्कन	pred_false
valkkan	वल्कन	वा्ककण	pred_false
velkan	वल्कन	वेलककन	pred_false
vash	वश	वाश	pred_false
vashikaran	वशीकरण	वाष्पीकरण	pred_false
vaangchuk	वांगचुक	वांगुचिक	pred_false
vangchuk	वांगचुक	वांगुचिक	pred_false
wangchuk	वांगचुक	वंंचुक	pred_false
want	वांट	वंत	pred_false
vije	वाइज	विजे	pred_false
vise	वाइज	वीज	pred_false
wise	वाइज	वीज	pred_false
vatar	वाटर	वातर	pred_false
water	वाटर	वाटर	pred_true
watson	वाटसन	वास्टन	pred_false
wattson	वाटसन	वात्सों	pred_false
vaan	वाण	वान	pred_false
waan	वाण	वान	pred_false
vaanon	वाणों	वानों	pred_false
vanon	वाणों	वनों	pred_false
wanon	वाणों	वनों	pred_false
vatanukulan	वातानुकूलन	वातनुकूना	pred_false
watanukoollan	वातानुकूलन	वातुनूलना	pred_false
vaadak	वादक	वादक	pred_true
vadak	वादक	वादक	pred_true
vaadiyon	वादियों	वाड़ियों	pred_false
vadiyon	वादियों	वाडियों	pred_false
wadiyon	वादियों	वाडियों	pred_false
vayana	वायना	वायना	pred_true
vayna	वायना	वायना	pred_true
wayna	वायना	वायना	pred_true
wireless	वायरलेस	वायरलेस	pred_true
wirerless	वायरलेस	वायर्लेस	pred_false
warrior	वारियर्स	वारियर	pred_false
warriors	वारियर्स	वारियर्स	pred_true
valve	वाल्व	वाल्वे	pred_false
wolv	वाल्व	वोल्व	pred_false
vastavik	वास्तविक	वास्तविक	pred_true
vastvik	वास्तविक	वसस्त्विक	pred_false
vaahikayen	वाहिकाएं	वाहिकाएं	pred_true
vahikayen	वाहिकाएं	वाहिकाएं	pred_true
wahikayan	वाहिकाएं	वाहिकायां	pred_false
winter	विंटर	विंटर	pred_true
vincent	विंसेंट	विंसेंट	pred_true
vikalpon	विकल्पों	विकलपों	pred_false
wicket	विकेट	विकेट	pred_true
vikramjeet	विक्रमजीत	विक्रमजीत	pred_true
vikramjit	विक्रमजीत	विक्रमाजित	pred_false
vichaarakon	विचारकों	विचारकों	pred_true
vicharakon	विचारकों	विचारकों	pred_true
vigyan	विज्ञान	विज्ञान	pred_true
vigyaani	विज्ञानी	विज्ञानी	pred_true
vigyani	विज्ञानी	विज्ञानी	pred_true
vigyaanon	विज्ञानों	विज्ञानों	pred_true
vigyanon	विज्ञानों	विज्ञानों	pred_true
vitthal	विट्ठल	वित्थल	pred_false
viththal	विठ्ठल	वित्थल	pred_false
vitthal	विठ्ठल	वित्थल	pred_false
vitark	वितर्क	विटर्क	pred_false
vidhaaein	विद्याएं	विधाएं	pred_false
vidyaayein	विद्याएं	विद्याएं	pred_true
vidyaen	विद्याएं	विद्याएं	pred_true
vidhaaon	विद्याओं	विधाओं	pred_false
vidyaaon	विद्याओं	विद्याओं	pred_true
vidyaon	विद्याओं	विद्याओं	pred_true
vidhansabhaein	विधानसभाएं	विधानसाभाएं	pred_false
vidhansabhaen	विधानसभाएं	विधानसभाएं	pred_true
vidhivat	विधिवत	विधिवात	pred_false
vidhut	विधुत	विध्युत	pred_false
vinasht	विनष्ट	विनाष्ट	pred_false
vineet	विनीत	विनीत	pred_true
vinit	विनीत	विनित	pred_false
vipreetataa	विपरीतता	विपरितता	pred_false
vipritata	विपरीतता	विप्रिता	pred_false
vipra	विप्रा	विपररा	pred_false
vipro	विप्रो	विप्रो	pred_true
wipro	विप्रो	विप्रो	pred_true
vibha	विभा	विभा	pred_true
vibhajak	विभाजक	विभाजक	pred_true
vibhram	विभ्रम	विभर्म	pred_false
vibhrm	विभ्रम	विभर्म	pred_false
vibram	विभ्रम	विब्राम	pred_false
vimarsh	विमर्श	विमार्श	pred_false
vimarsho	विमर्शों	विमारशों	pred_false
vimarshon	विमर्शों	विमारशों	pred_false
virajati	विराजती	विराजती	pred_true
virechan	विरेचन	विरेचन	pred_true
virodh	विरोध	विरोध	pred_true
virodhabhasi	विरोधाभासी	विरोधासासी	pred_false
virodhabhason	विरोधाभासों	विरोधासाओं	pred_false
vividh	विविध	विविध	pred_true
vivekahin	विवेकहीन	विवेखाहीन	pred_false
vivekheen	विवेकहीन	विवेखन	pred_false
visheshan	विशेषण	विशेषण	pred_true
visheshanon	विशेषणों	विशेषणों	pred_true
visheshaadhikaar	विशेषाधिकार	विशेषादिकार	pred_false
visheshadhikar	विशेषाधिकार	विशेषेधिकार	pred_false
vishwasaniy	विश्वसनीय	विश्वासनीय	pred_false
vishwasniiya	विश्वसनीय	विश्वासनीय	pred_false
vishwasaniyata	विश्वसनीयता	विश्वासनिता	pred_false
vishwasniiyataa	विश्वसनीयता	विश्वासनिता	pred_false
vishahin	विषहीन	विशाहीन	pred_false
vishhin	विषहीन	विषिन	pred_false
vishanu	विष्णु	विषाणु	pred_false
vishnu	विष्णु	विष्णु	pred_true
vlc	वीएलसी	वीएलसी	pred_true
weeks	वीक्स	विक्स	pred_false
veerchand	वीरचंद	वीरचंद	pred_true
virchand	वीरचंद	विरचंद	pred_false
veeresh	वीरेश	वीरेश	pred_true
viresh	वीरेश	वीरेश	pred_true
vritton	वृत्तों	वृत्तों	pred_true
vruton	वृत्तों	वृतों	pred_false
vrutton	वृत्तों	वृत्तों	pred_true
venkataraman	वेंकटरमन	वेंकटरमण	pred_false
venkatraman	वेंकटरमन	वेंकटरमान	pred_false
ved	वेड	वेद	pred_false
wade	वेड	वाडे	pred_false
wed	वेड	वेड	pred_true
wedding	वेडिंग	वेडिंग	pred_true
vediyon	वेदियों	वेदियों	pred_true
vedon	वेदों	वेदों	pred_true
venezuela	वेनेजुएला	वेनेमाला	pred_false
veronica	वेरोनिका	वेरोनिका	pred_true
veronika	वेरोनिका	वेरोणिका	pred_false
weronika	वेरोनिका	वेरोनिका	pred_true
velvet	वेलवेट	वेलवेट	pred_true
welwet	वेलवेट	वेलवेट	pred_true
welder	वेल्डर	वेल्डर	pred_true
weldor	वेल्डर	वेल्डोर	pred_false
welding	वेल्डिंग	वेल्डिंग	pred_true
wealth	वेल्थ	वेल्थ	pred_true
vellur	वेल्लूर	वेल्लुर	pred_false
velur	वेल्लूर	वेलूर	pred_false
vesh	वेश	वेश	pred_true
wasting	वेस्टिंग	वेस्टिंग	pred_true
westing	वेस्टिंग	वेस्टिंग	pred_true
wastinghouse	वेस्टिंगहाउस	वास्टिनोहोस	pred_false
westinghouse	वेस्टिंगहाउस	वेस्टिनोज	pred_false
vaisley	वेस्ले	वैसले	pred_false
vesle	वेस्ले	वेस्ले	pred_true
wesle	वेस्ले	वेसल	pred_false
vaigyaanik	वैज्ञानिक	वैज्ञानिक	pred_true
vaigyanik	वैज्ञानिक	वैज्ञानिक	pred_true
vegyanik	वैज्ञानिक	वेज्ञानिक	pred_false
vaigyaanikta	वैज्ञानिकता	वैज्ञानिकता	pred_true
vaigyanikata	वैज्ञानिकता	वैज्ञानिकता	pred_true
vaigyanikta	वैज्ञानिकता	वैज्ञानिकता	pred_true
vaitravati	वैत्रवती	वैत्रवती	pred_true
vaitrawati	वैत्रवती	वैत्रवती	pred_true
vaimanasy	वैमनस्य	वैमानस्य	pred_false
vaimanasya	वैमनस्य	वैमानस्य	pred_false
vaimanya	वैमनस्य	वैमान्य	pred_false
very	वैरी	वेरी	pred_false
vaisaakh	वैशाख	वैसाख	pred_false
vaishakh	वैशाख	वैशाख	pred_true
vaishaakhi	वैशाखी	वैशाखी	pred_true
vaishakhi	वैशाखी	वैशाखी	pred_true
vaishnodevi	वैष्णोदेवी	वैश्णोदेवी	pred_false
vyaktigat	व्यक्तिगत	व्यक्तित	pred_false
vyagr	व्यग्र	व्याग्र	pred_false
vyagra	व्यग्र	व्याग्रा	pred_false
vyatit	व्यतीत	व्यतित	pred_false
vytit	व्यतीत	व्यतित	pred_false
vyabhichar	व्यभिचार	व्याभीचार	pred_false
vyabhichari	व्यभिचार	व्याभिचारी	pred_false
vyavadhan	व्यवधान	व्यववाधन	pred_false
vyavdhan	व्यवधान	व्यवधान	pred_true
vyavahargat	व्यवहारगत	व्यवहार्गत	pred_false
vyvhargat	व्यवहारगत	व्यवहार्त	pred_false
vyaghat	व्याघात	व्याघाट	pred_false
vyapak	व्यापक	व्यापक	pred_true
vlad	व्लाद	व्लैड	pred_false
wlaad	व्लाद	व्ााड	pred_false
vladimir	व्लादिमीर	व्लाडीमीर	pred_false
shanghai	शंघाई	शंघाई	pred_true
shatpath	शतपथ	शटपाठ	pred_false
shanivar	शनिवार	शानीवार	pred_false
shaniwar	शनिवार	शनीवार	pred_false
shabana	शबाना	शबाना	pred_true
shbana	शबाना	शबाना	pred_true
shabdarth	शब्दार्थ	शब्रद्थ	pred_false
shamadan	शमादान	शमादन	pred_false
shmadan	शमादान	शमादन	pred_false
shamitabh	शमिताभ	शमीताब	pred_false
shamil	शमिल	शामिल	pred_false
shmil	शमिल	शमील	pred_false
sharabon	शराबों	शारबों	pred_false
shrabon	शराबों	श्रबों	pred_false
shararat	शरारत	शरारत	pred_true
shrart	शरारत	श्रार्त	pred_false
sharmana	शर्माना	शर्मना	pred_false
shaharwasiyon	शहरवासियों	शहरवासियों	pred_true
shahrvasiyon	शहरवासियों	शहरवासियों	pred_true
shervasiyon	शहरवासियों	शेरवासियों	pred_false
shahdara	शहादरा	शाहदरा	pred_false
shaantikaal	शांतिकाल	शांतिकाल	pred_true
shantikal	शांतिकाल	शांतिकाल	pred_true
shaao	शाओ	शाओ	pred_true
shao	शाओ	शाओ	pred_true
shaakir	शाकिर	शाकीर	pred_false
shakir	शाकिर	शाकिर	pred_true
shaakhaaen	शाखाएं	शाखाएं	pred_true
shakhayan	शाखाएं	शखायां	pred_false
shakhayen	शाखाएं	शखाएं	pred_false
shayak	शायक	शयाक	pred_false
shaavakon	शावकों	शावकों	pred_true
shavakon	शावकों	शवकों	pred_false
shavkon	शावकों	शक्कों	pred_false
shaasaka	शासक	शासका	pred_false
shasak	शासक	शसक	pred_false
sasakon	शासकों	साकों	pred_false
shaasakon	शासकों	शासकों	pred_true
shasakon	शासकों	शासकों	pred_true
shipra	शिप्रा	शिप्र	pred_false
shirke	शिर्के	शिरके	pred_false
sheershakon	शीर्षकों	शीर्शकों	pred_false
shirshakon	शीर्षकों	शीर्षकों	pred_true
shirshkon	शीर्षकों	शीर्षकों	pred_true
shujaat	शुजात	शुजात	pred_true
shujat	शुजात	शुजात	pred_true
shooting	शुटिंग	शूटिंग	pred_false
shutting	शुटिंग	शट्टिंग	pred_false
should	शुड	शोल्ड	pred_false
shud	शुड	शुद	pred_false
shubhankar	शुभंकर	शुभनकर	pred_false
shumaali	शुमाली	शुमाली	pred_true
shumali	शुमाली	शुमाली	pred_true
shringaar	शृंगार	श्रृंगार	pred_false
shringar	शृंगार	श्रृंगार	pred_false
shrungar	शृंगार	श्रंगर	pred_false
sheling	शेलिंग	शेलिंग	pred_true
shelling	शेलिंग	शेल्लिंग	pred_false
shaili	शैली	शैली	pred_true
shaly	शैली	शल्य	pred_false
sheli	शैली	शेली	pred_false
shaishav	शैशव	शैशाव	pred_false
sean	शॉन	सीन	pred_false
shaun	शॉन	शौन	pred_false
shawn	शॉन	शॉन	pred_true
short	शोर्ट	शोर्ट	pred_true
sure	श्योर	सुरे	pred_false
shrankhala	श्रंखला	श्रृंखला	pred_false
shrankhalaa	श्रंखला	श्रृंखला	pred_false
shrunkhla	श्रंखला	शृंखला	pred_false
shrankhalaaon	श्रंखलाओं	श्रृंखलाओं	pred_false
shrinkhalaon	श्रंखलाओं	श्रृंखलाओं	pred_false
shrunkhlaon	श्रंखलाओं	शृंखलाओं	pred_false
shravani	श्रावणी	श्रवनी	pred_false
shrikar	श्रीकर	श्रीकर	pred_true
shrikhand	श्रीखंड	श्रीखंड	pred_true
shrimati	श्रीमति	श्रीमती	pred_false
shriram	श्रीराम	श्रीराम	pred_true
sriram	श्रीराम	श्रीराम	pred_true
shrotaon	श्रोताओं	श्रोताओं	pred_true
shat	षट्	शट	pred_false
sankhyaein	संख्याएं	संख्याएं	pred_true
sankhyaen	संख्याएं	संख्याएं	pred_true
sankhyayen	संख्याएं	संख्याएं	pred_true
sanghanit	संघनित	संघानित	pred_false
sanghnit	संघनित	संघनित	pred_true
sanchayan	संचयन	संचायन	pred_false
sanchar	संचार	संचर	pred_false
sanchaari	संचारी	संचारी	pred_true
sanchari	संचारी	संचारी	pred_true
sanchalanon	संचालनों	संचालनों	pred_true
sanchalnon	संचालनों	संचालनों	pred_true
sanjay	संजय	संजय	pred_true
sanjeevan	संजीवन	संजीवन	pred_true
sanjivan	संजीवन	संजीवन	pred_true
santati	संतति	संताती	pred_false
sandarbh	संदर्भ	संदर्भ	pred_true
sandarbha	संदर्भ	संदर्भ	pred_true
sandrbh	संदर्भ	संद्रभ	pred_false
sandarbhon	संदर्भों	संदर्भों	pred_true
sandrbhon	संदर्भों	संद्रभों	pred_false
sandali	संदली	सांडली	pred_false
sandli	संदली	सांडली	pred_false
sandhan	संधान	साधन	pred_false
samprati	संप्रति	संप्रति	pred_true
samprti	संप्रति	संप्रति	pred_true
samprabhu	संप्रभु	संप्रभा	pred_false
samprbhu	संप्रभु	संप्रभु	pred_true
samprabhuta	संप्रभुता	संप्रभूता	pred_false
samprbhuta	संप्रभुता	संप्रभूता	pred_false
sambit	संबित	संबित	pred_true
sambhalane	संभालने	संभानला	pred_false
sambhalne	संभालने	संभाने	pred_false
sambhrant	संभ्रांत	संभारत	pred_false
sanbharnt	संभ्रांत	संभार्त	pred_false
sanyog	संयुक्त	संयोग	pred_false
sanyukt	संयुक्त	सनयुक्त	pred_false
sanyukta	संयुक्त	सनयुक्त	pred_false
sanyukta	संयुक्ता	सनयुक्त	pred_false
sanyogvash	संयोगवश	संयोगवाश	pred_false
sanyojan	संयोजन	संयोजन	pred_true
sanyojanon	संयोजनों	संयोजनों	pred_true
sanyojnon	संयोजनों	संयोजनों	pred_true
samvedikaran	संवेदीकरण	संवेदीकरण	pred_true
sanvedikaran	संवेदीकरण	संवेदीकरण	pred_true
samshayon	संशयों	समश्यों	pred_false
sanshayon	संशयों	संशायों	pred_false
sanshyon	संशयों	संश्यों	pred_false
sanskaar	संस्कार	संस्कार	pred_true
sanskar	संस्कार	संस्कर	pred_false
sanskaari	संस्कारी	संस्कारी	pred_true
sanskari	संस्कारी	संस्कारी	pred_true
sanskrit	संस्कृत	संस्कृत	pred_true
sanskurt	संस्कृत	संस्कुर	pred_false
sanskritiyan	संस्कृतियां	संस्तियां	pred_false
sanskrutiyan	संस्कृतियां	संस्कृतियां	pred_true
sanskritiyon	संस्कृतियों	संस्कृतियों	pred_true
sanskrutiyon	संस्कृतियों	संस्कृतियों	pred_true
sanasthit	संस्थित	सनस्थित	pred_false
sansthit	संस्थित	संस्थित	pred_true
sanasthita	संस्थिता	सनस्थित	pred_false
sansthita	संस्थिता	संस्थिता	pred_true
sakara	सकरा	सकरा	pred_true
sakra	सकरा	सकरा	pred_true
sakshan	सक्शन	साक्षण	pred_false
suction	सक्शन	स्क्शन	pred_false
sacchidanand	सच्चिदानंद	सच्चिदाद	pred_false
sachhidanand	सच्चिदानंद	सचिधानद	pred_false
sachidanand	सच्चिदानंद	सचिदादं	pred_false
sajja	सज्जा	सज्जा	pred_true
sat	सत	सत	pred_true
satpal	सतपाल	सत्पल	pred_false
satluj	सतलुज	सतलुज	pred_true
sataane	सताने	सताने	pred_true
satane	सताने	सतने	pred_false
sate	सते	सेट	pred_false
satti	सत्ती	सत्ती	pred_true
satvat	सत्वत	सत्वत	pred_true
sadanand	सदानंद	सदानंद	pred_true
sapane	सपने	सपनने	pred_false
sapne	सपने	सपने	pred_true
sapney	सपने	सपने	pred_true
saparivaar	सपरिवार	सपरीवार	pred_false
sapariwar	सपरिवार	सपरीवार	pred_false
sparivar	सपरिवार	स्पीरवार	pred_false
sapaat	सपाट	सपात	pred_false
sapat	सपाट	सपात	pred_false
sapate	सपाटे	सपाते	pred_false
sapatey	सपाटे	सपपते	pred_false
saptakranti	सप्तक्रांति	सपप्तकणीति	pred_false
saptkraanti	सप्तक्रांति	सपप्तकणिति	pred_false
saptapadi	सप्तपदी	सप्ताादी	pred_false
saptpadi	सप्तपदी	सप्तपादी	pred_false
saptari	सप्तरी	सप्तरी	pred_true
sapramaan	सप्रमाण	सप्रमण	pred_false
sapraman	सप्रमाण	सप्रमान	pred_false
submit	सबमिट	सब्मित	pred_false
sabmission	सबमिशन	साबिसिन	pred_false
submission	सबमिशन	सस्मीसन	pred_false
sabhaein	सभाएं	सभाएं	pred_true
sabhaen	सभाएं	सभाएं	pred_true
sabhayen	सभाएं	सभाएं	pred_true
sabhen	सभाएं	सभें	pred_false
sabhasadon	सभासदों	सभासदों	pred_true
sabhyata	सभ्यता	सभ्यता	pred_true
samjhoonga	समझूंगा	समझोंगा	pred_false
samjhunga	समझूंगा	समझंगा	pred_false
samjhungaa	समझूंगा	समझंगा	pred_false
saman	समन	सममान	pred_false
samanvayaka	समन्वयक	समन्वयका	pred_false
samanwayaka	समन्वयक	समन्वयका	pred_false
samnvyak	समन्वयक	सान्वययक	pred_false
samaadhaan	समाधान	समाधान	pred_true
samadhan	समाधान	समाधन	pred_false
samadhiyon	समाधियों	समाधियों	pred_true
samadjiyon	समाधियों	समादजियों	pred_false
samalakha	समालखा	समलाखा	pred_false
samalakhaa	समालखा	समलखखा	pred_false
samahaar	समाहार	समाहार	pred_true
samahar	समाहार	समाहार	pred_true
samitiyan	समितियां	समितियां	pred_true
sametati	समेटती	समेटती	pred_true
sametti	समेटती	समेटी	pred_false
sarka	सरका	सरका	pred_true
sarkaa	सरका	सरका	pred_true
sarkarein	सरकारें	सरकारें	pred_true
sarkaren	सरकारें	सरकरें	pred_false
sarkaaron	सरकारों	सरकारों	pred_true
sarkaron	सरकारों	सरकारों	pred_true
sargana	सरगना	सारगना	pred_false
sarganaon	सरगनाओं	सरगनाओं	pred_true
sargi	सरगी	सारी	pred_false
sarguja	सरगुजा	सररगजा	pred_false
sarjuga	सरगुजा	सरजुगा	pred_false
sarsa	सरसा	सरसा	pred_true
sarsaa	सरसा	सरसा	pred_true
sarahind	सरहिंद	सारहिंद	pred_false
sarhind	सरहिंद	सारींद	pred_false
sirhind	सरहिंद	सीरीहिंद	pred_false
saraaha	सराहा	सराहा	pred_true
saraha	सराहा	सराहा	pred_true
saraahi	सराही	साराही	pred_false
sarahi	सराही	सारही	pred_false
salaahkar	सलाहकार	सलाहकर	pred_false
salahkaar	सलाहकार	सलाहकार	pred_true
salahkar	सलाहकार	सलाहकर	pred_false
saleeb	सलीब	सलीब	pred_true
salib	सलीब	सालिब	pred_false
select	सलेक्ट	सेलेक्ट	pred_false
saltanat	सल्तनत	सल्तान	pred_false
saltnat	सल्तनत	सल्टन	pred_false
savaal	सवाल	सवाल	pred_true
saval	सवाल	सवाल	pred_true
sawaal	सवाल	सवाल	pred_true
sawal	सवाल	सावल	pred_false
sahakalaakar	सहकलाकार	सहकालकर	pred_false
sahakalakar	सहकलाकार	सहकालकर	pred_false
sahkalakar	सहकलाकार	सहकालकर	pred_false
sahadev	सहदेव	सहाेेव	pred_false
sahdev	सहदेव	सहदेव	pred_true
sahrawat	सहरावत	सहरावत	pred_true
sherawat	सहरावत	शेरावत	pred_false
sahooliyata	सहूलियत	सहूलियता	pred_false
sahuliyat	सहूलियत	सहूलियत	pred_true
sahuuliyata	सहूलियत	सहूलियता	pred_false
saanketika	सांकेतिक	सांकतिका	pred_false
sanketik	सांकेतिक	सैक्टिक	pred_false
saimans	साइमंस	सैमांस	pred_false
simmons	साइमंस	सिमंस	pred_false
symons	साइमंस	सायमंस	pred_false
saima	साइमा	सैमा	pred_false
sagarika	सागरिका	सगरिका	pred_false
sagrika	सागरिका	सगरीका	pred_false
saga	सागा	सागा	pred_true
saajan	साजन	साजन	pred_true
sajan	साजन	सजन	pred_false
saajsajja	साजसज्जा	साजसजजा	pred_false
sajsajja	साजसज्जा	साजसाजा	pred_false
saja	साजा	सजा	pred_false
saathsaath	साथसाथ	साठसाथ	pred_false
sathsath	साथसाथ	सत्थाथ	pred_false
sathiya	साथिया	साहिया	pred_false
saabah	साबाह	सााह	pred_false
sabah	साबाह	सााह	pred_false
samanjasy	सामंजस्य	समांजी	pred_false
samanjasya	सामंजस्य	समांज्य	pred_false
samoa	सामोआ	समो	pred_false
samoaa	सामोआ	समो	pred_false
saayn	सायं	सायं	pred_true
sayan	सायं	सायन	pred_false
saym	सायं	सायम	pred_false
saira	सायरा	सैरा	pred_false
sayara	सायरा	सयारा	pred_false
sayra	सायरा	सायरा	pred_true
salve	साल्वे	सलवे	pred_false
sahab	साहब	सहाब	pred_false
singapore	सिंगापुर	सिंगपोर	pred_false
singaar	सिंगार	सिंगार	pred_true
singar	सिंगार	सिंगार	pred_true
singer	सिंगार	सिंगर	pred_false
singhaadey	सिंघाड़े	सिंहड़े	pred_false
singhade	सिंघाड़े	सिंहड़े	pred_false
singhde	सिंघाड़े	सिंहड़े	pred_false
singhre	सिंघाड़े	सिंघरे	pred_false
singhi	सिंघी	सिंही	pred_false
singha	सिंहा	सिंघा	pred_false
sinha	सिंहा	सिन्हा	pred_false
siera	सिएरा	सीयरा	pred_false
sierra	सिएरा	सीयरा	pred_false
sikud	सिकुड़	सिकुड़	pred_true
signals	सिगनल्स	सिग्लास	pred_false
cigaretton	सिगरेटों	सिगररेटों	pred_false
cigretton	सिगरेटों	सिर्रेटन	pred_false
siddhivat	सिद्धवट	सिद्धिवात	pred_false
siddhvat	सिद्धवट	सिद्धवत	pred_false
siddhwat	सिद्धवट	सिद्धवत	pred_false
sinabang	सिनाबंग	सिनबंग	pred_false
synapse	सिनेप्स	सीन्पस्स	pred_false
sipah	सिपाह	सीपह	pred_false
sipaha	सिपाह	सीपहा	pred_false
sipahiyon	सिपाहियों	सिपहाियों	pred_false
sipahi	सिपाही	सीपही	pred_false
sim	सिम	सिम	pred_true
simat	सिमट	सीमात	pred_false
simatataa	सिमटता	सीमतता	pred_false
simatta	सिमटता	सीमत्ता	pred_false
simtata	सिमटता	सीम्ता	pred_false
simtataa	सिमटता	सीम्ता	pred_false
cement	सिमटे	सेमेंट	pred_false
simate	सिमटे	सीमते	pred_false
simi	सिमी	सीमी	pred_false
simmy	सिमी	सिम्मी	pred_false
sims	सिम्स	सिम्स	pred_true
siyasi	सियासी	सीयासी	pred_false
siyah	सियाह	सियाह	pred_true
siyaha	सियाह	सियाहा	pred_false
sirpur	सिरपुर	सीरपुर	pred_false
sivan	सिवान	सिवन	pred_false
siwan	सिवान	सिवन	pred_false
sisva	सिसवा	सिस्व	pred_false
siswa	सिसवा	सिस्व	pred_false
cil	सीआईएल	सील	pred_false
csi	सीएसआई	सीसीआईईईई	pred_false
sikar	सीकर	सीकर	pred_true
seaten	सीटें	सीतें	pred_false
sitaram	सीताराम	सीताराम	pred_true
sitaharan	सीताहरण	सिताहरण	pred_false
cpm	सीपीएम	सीपीएम	pred_true
cps	सीपीएस	सीपीएस	pred_true
cbse	सीबीएसई	सीबीएस	pred_false
seem	सीम	सीम	pred_true
sim	सीम	सिम	pred_false
sealed	सील्ड	सीलेड	pred_false
shield	सील्ड	शिल्ड	pred_false
ccd	सीसीडी	सीसीडी	pred_true
sugamata	सुगमता	सुगामता	pred_false
sugmta	सुगमता	सुम्मता	pred_false
sujan	सुजेन	सुजन	pred_false
sujen	सुजेन	सूजें	pred_false
suken	सुजेन	सुकेन	pred_false
sujain	सुजैन	सुजान	pred_false
sujhaati	सुझाती	सुझाती	pred_true
sujhati	सुझाती	सुझाती	pred_true
sutali	सुतली	सूतली	pred_false
sutli	सुतली	सूतली	pred_false
suta	सुता	सूटा	pred_false
sdueep	सुदीप	सदीप	pred_false
sudip	सुदीप	सुदीप	pred_true
sudhaargrah	सुधारगृह	सुधाग्रह	pred_false
sudhargrih	सुधारगृह	सुधारग्रहि	pred_false
sudhargruh	सुधारगृह	सुधारगुरह	pred_false
sunaaron	सुनारों	सुनारों	pred_true
sunaron	सुनारों	सुनरों	pred_false
sunaseer	सुनासीर	सुनासीर	pred_true
sunasir	सुनासीर	सुनासिर	pred_false
suneeti	सुनीति	सुनीती	pred_false
suniti	सुनीति	सुनिती	pred_false
sunega	सुनेगा	सुनेगा	pred_true
suneyga	सुनेगा	सुनेगा	pred_true
superhit	सुपरहिट	सुपरहीत	pred_false
supachy	सुपाच्य	सुपाची	pred_false
supachya	सुपाच्य	सुपच्य	pred_false
supachye	सुपाच्य	सुपच्य	pred_false
subhaay	सुभाय	सुभाय	pred_true
subhay	सुभाय	सुभाय	pred_true
surveen	सुरवीन	सूर्वीन	pred_false
survin	सुरवीन	सूर्विन	pred_false
surana	सुराणा	सुरना	pred_false
sulkhan	सुलखान	सुलखन	pred_false
suljaayi	सुलझाई	सुलझाई	pred_true
suljayi	सुलझाई	सुलझाई	pred_true
suljhai	सुलझाई	सुलझाई	pred_true
sulzai	सुलझाई	सुलझाई	pred_true
sultana	सुलताना	सुल्ताना	pred_false
sulaati	सुलाती	सुलाती	pred_true
sulati	सुलाती	सुलती	pred_false
susanskrit	सुसंस्कृत	सुसस्नकृत	pred_false
susanskrut	सुसंस्कृत	सुसस्ंृत	pred_false
suhagin	सुहागिन	सुहांन	pred_false
soond	सूंड़	सूंड	pred_false
sund	सूंड़	सूंड	pred_false
suiyan	सूइयां	सुयान	pred_false
sukhati	सूखती	सूखती	pred_true
sukhti	सूखती	सूखती	pred_true
sukhakar	सूखाकर	सुखाकर	pred_false
soochak	सूचक	सूचक	pred_true
suchak	सूचक	सूचक	pred_true
sooja	सूजा	सूजा	pred_true
suja	सूजा	सूजा	pred_true
suba	सूबा	सुबा	pred_false
sube	सूबे	सुबे	pred_false
sooraj	सूरज	सूरज	pred_true
suraj	सूरज	सुरज	pred_false
surinaam	सूरीनाम	सुरीनाम	pred_false
surinama	सूरीनाम	सुरीनामा	pred_false
suriname	सूरीनाम	सूरीनामे	pred_false
suryadev	सूर्यदेव	सूर्यादेव	pred_false
sendha	सेंधा	सेंधा	pred_true
senvai	सेंवई	सेनेवाई	pred_false
sevai	सेंवई	सेवाई	pred_false
sensing	सेंसिंग	सेंसिंग	pred_true
sexual	सेक्सुअल	सेक्वाल	pred_false
saturday	सेटरडे	सतुर्दय	pred_false
seti	सेटी	सेती	pred_false
seto	सेटो	सेटो	pred_true
seth	सेथ	सेठ	pred_false
safety	सेफ्टी	सफेत्य	pred_false
semen	सेमिन	सेमेन	pred_false
semin	सेमिन	सेमिन	pred_true
self	सेल्फ	सेल्फ	pred_true
selfie	सेल्फी	सेल्फी	pred_true
save	सेव	साव	pred_false
sev	सेव	सेव	pred_true
sevakon	सेवकों	सेवकों	pred_true
sevkon	सेवकों	सेवकों	pred_true
samuels	सैम्युल्स	सैमुय्स	pred_false
celery	सैलरी	सेलरी	pred_false
salary	सैलरी	सालारी	pred_false
sakar	सॉकर	सकर	pred_false
socar	सॉकर	सोकर	pred_false
soccer	सॉकर	सॉकरसर	pred_false
songs	सॉन्ग्स	सोंग्स	pred_false
solicitor	सॉलिसिटर	सोलीसिटर	pred_false
sochane	सोचने	सोचने	pred_true
sochne	सोचने	सोचने	pred_true
sonu	सोनू	सोनू	pred_true
soma	सोमा	सोमा	pred_true
spma	सोमा	ससपीएमए	pred_false
somi	सोमी	सोमी	pred_true
soy	सोय	सोय	pred_true
soya	सोया	सोया	pred_true
solitaire	सोलिटेयर	सोलीएर	pred_false
soharai	सोहराई	सोहराई	pred_true
sohrai	सोहराई	सोहराई	pred_true
sohaval	सोहावल	सोहावल	pred_true
sohawal	सोहावल	सोहावल	pred_true
saunpane	सौंपने	सौंपने	pred_true
sonpne	सौंपने	सौनपेन	pred_false
scala	स्काला	स्केला	pred_false
skala	स्काला	स्काला	pred_true
ski	स्की	सीएी	pred_false
scootaron	स्कूटरों	स्कूटरों	pred_true
scooteron	स्कूटरों	स्कूटरों	pred_true
skootaron	स्कूटरों	स्कूटरों	pred_true
scandinavia	स्कैंडिनेविया	स्कैंडिनावी	pred_false
scaining	स्कैनिंग	स्कैनिंग	pred_true
scanning	स्कैनिंग	स्केंिंग	pred_false
squash	स्क्वाश	स्क्वाश	pred_true
squash	स्क्वैश	स्क्वाश	pred_false
skhalan	स्खलन	स्खलन	pred_true
stain	स्टैन	स्टेन	pred_false
stan	स्टैन	स्टन	pred_false
stop	स्टॉप	स्टॉप	pred_true
stops	स्टॉप्स	स्टोप्स	pred_false
stone	स्टोन	स्टोन	pred_true
straws	स्ट्रास	स्ट्रावस	pred_false
stress	स्ट्रास	स्ट्रेस	pred_false
stra	स्ट्रे	स्ट्रा	pred_false
stray	स्ट्रे	स्ट्रे	pred_true
stre	स्ट्रे	स्ट्रे	pred_true
strocks	स्ट्रोक्स	स्ट्रॉक्स	pred_false
strokes	स्ट्रोक्स	स्ट्रोक्स	pred_true
stan	स्तन	स्टन	pred_false
stanadhari	स्तनधारी	स्तनधारी	pred_true
standhaari	स्तनधारी	स्तंधारी	pred_false
standhari	स्तनधारी	स्तंधारी	pred_false
sthiti	स्तिथि	स्थिति	pred_false
stithi	स्तिथि	स्तिथी	pred_false
stuti	स्तुति	स्टूटी	pred_false
sthitiyaan	स्थितियां	स्थितियां	pred_true
sthitiyan	स्थितियां	स्थितियां	pred_true
sthitiyon	स्थितियों	स्थितियों	pred_true
sthool	स्थूल	स्थूल	pred_true
sthul	स्थूल	स्थुल	pred_false
sthoolta	स्थूलता	स्थूलता	pred_true
sthulata	स्थूलता	स्थुलता	pred_false
sneakers	स्नीकर्स	स्नेकर्स	pred_false
snickers	स्नीकर्स	स्नाइकर्स	pred_false
snikarse	स्नीकर्स	स्नीकर्स	pred_true
spear	स्पीयर	स्पेयर	pred_false
spell	स्पेल	स्पेल	pred_true
spelar	स्पेलर	स्पेलर	pred_true
speller	स्पेलर	स्पेलर	pred_true
sprint	स्प्रिट	स्प्रिंट	pred_false
sprit	स्प्रिट	स्प्रिट	pred_true
spray	स्प्रे	स्प्रय	pred_false
spry	स्प्रे	एसप्री	pred_false
sfoorti	स्फूर्ति	स्फूर्ती	pred_false
sfurti	स्फूर्ति	स्फूर्ती	pred_false
sphoorti	स्फूर्ति	स्फूर्ति	pred_true
slide	स्लाइड	स्लाइड	pred_true
slider	स्लाइडर	स्लाइडर	pred_true
slaaidon	स्लाइडों	स्लाइडों	pred_true
slidon	स्लाइडों	स्लीडन	pred_false
sliders	स्लाइड्स	स्लाइडर्स	pred_false
slides	स्लाइड्स	स्लाइड्स	pred_true
slice	स्लाइस	स्लाइस	pred_true
slash	स्लैश	स्लाश	pred_false
swaroopon	स्वरुपों	स्वरूपों	pred_false
swarupon	स्वरुपों	स्वरूपों	pred_false
swa	स्वा	स्व	pred_false
swaachaalit	स्वाचालित	स्वचालित	pred_false
swachalit	स्वाचालित	स्वचालित	pred_false
swaarthparak	स्वार्थपरक	स्वार्थापक	pred_false
swarthparak	स्वार्थपरक	स्वार्थापरक	pred_false
swiftlate	स्विफ्टलेट	स्विफ्टलाइट	pred_false
swiftlet	स्विफ्टलेट	स्विफ्टलेट	pred_true
sweekarte	स्वीकारते	स्वीकारते	pred_true
swikarte	स्वीकारते	स्वीकारते	pred_true
sweet	स्वीट	स्वीट	pred_true
sweep	स्वीप	स्वीप	pred_true
sweccha	स्वेच्छा	स्वेच्छा	pred_true
swecha	स्वेच्छा	स्वेच्छा	pred_true
swechha	स्वेच्छा	स्वेच्छाछा	pred_false
sweta	स्वेता	स्वेटा	pred_false
swap	स्वैप	स्वप	pred_false
swipe	स्वैप	स्वीप	pred_false
handiya	हंडिया	हैंडिया	pred_false
handiyaa	हंडिया	हैंडिया	pred_false
hundiya	हंडिया	हुंडिया	pred_false
hakikat	हकीकत	हाकिकात	pred_false
haqeeqat	हकीकत	हकीकत	pred_true
hathiya	हथिया	हथिया	pred_true
hamala	हमला	हमाला	pred_false
hamla	हमला	हमला	pred_true
hamalavar	हमलावर	हमलावर	pred_true
hamlavar	हमलावर	हमलावर	pred_true
humlavar	हमलावर	हमलावर	pred_true
hamaal	हमाल	हमाल	pred_true
hamal	हमाल	हमाल	pred_true
hercules	हरक्यूलिस	हेर्कूल्स	pred_false
hardas	हरदास	हादास	pred_false
harpaal	हरपाल	हरपाल	pred_true
harpal	हरपाल	हरपाल	pred_true
harvansh	हरवंश	हरवांश	pred_false
haraval	हरावल	हरावल	pred_true
harawal	हरावल	हरावाल	pred_false
hurricane	हरिकेन	हुरीकान	pred_false
harijan	हरिजन	हरिजन	pred_true
hariyali	हरियाली	हरियाली	pred_true
harshit	हर्षित	हर्षित	pred_true
haldi	हल्दी	हल्दी	pred_true
halla	हल्ला	हल्ला	pred_true
hawamahal	हवामहल	हवमहाल	pred_false
hawalaat	हवालात	हवलात	pred_false
hawalat	हवालात	हवालात	pred_true
hasino	हसीनों	हसीनो	pred_false
hasinon	हसीनों	हसीनों	pred_true
haan	हां	हान	pred_false
han	हां	हान	pred_false
haanfte	हांफते	हैंफती	pred_false
hafate	हांफते	हाफते	pred_false
hanfte	हांफते	हैंफ्टे	pred_false
higman	हाइमन	हिगमन	pred_false
hymen	हाइमन	हामन	pred_false
hadauti	हाड़ौती	हडौती	pred_false
haani	हानी	हानी	pred_true
hani	हानी	हानी	pred_true
haarjeet	हारजीत	हर्जीत	pred_false
harjeet	हारजीत	हरजीत	pred_false
haaranaa	हारना	हारणा	pred_false
harana	हारना	हराना	pred_false
harna	हारना	हरना	pred_false
haalchaal	हालचाल	हालचाल	pred_true
haalchal	हालचाल	हालचाल	pred_true
halchaal	हालचाल	हलचाल	pred_false
halchal	हालचाल	हलचल	pred_false
halt	हाल्ट	हल्ट	pred_false
hault	हाल्ट	हॉल्ट	pred_false
hahakar	हाहाकार	हाकर	pred_false
hingis	हिंगिस	हिंगिस	pred_true
hindan	हिंडन	हिंदन	pred_false
hindon	हिंडन	हिंडों	pred_false
hijada	हिजड़ा	हिजड़ा	pred_true
hijda	हिजड़ा	हिजड़ा	pred_true
hijbul	हिजबुल	हिजबुल	pred_true
hippo	हिप्पो	हिप्पो	pred_true
hippopotamus	हिप्पोपोटेमस	हिपपोप्सम	pred_false
himali	हिमाली	हिमाली	pred_true
hilane	हिलने	हिलाने	pred_false
hilne	हिलने	हिलने	pred_true
hisham	हिशाम	हिशम	pred_false
heeraganj	हीरागंज	हीरगंज	pred_false
hiraganj	हीरागंज	हिरागंज	pred_false
heroes	हीरोज	हेरोज	pred_false
heros	हीरोज	हेरोस	pred_false
hui	हुईं	हुई	pred_false
huin	हुईं	हुइं	pred_false
hooper	हूपर	हापर	pred_false
huppar	हूपर	हुप्पर	pred_false
hupper	हूपर	हुपर	pred_false
hegde	हेगडे	हेगड़े	pred_false
hemvati	हेमवती	हेमवती	pred_true
hemwati	हेमवती	हेमवाती	pred_false
help	हेल्प	हेल्प	pred_true
helper	हेल्पर	हेलपर	pred_false
haito	हैतो	हैतो	pred_true
hairam	हैरम	हैराम	pred_false
harem	हैरम	हरेम	pred_false
herald	हैराल्ड	हेराल्ड	pred_false
haive	हैव	हैवे	pred_false
have	हैव	हेव	pred_false
hong	हॉन्ग	होंग	pred_false
half	हॉफ	हाफ	pred_false
hoaf	हॉफ	होफ	pred_false
hounga	होऊंगा	हांगा	pred_false
holding	होल्डिंग	होल्डिंग	pred_true
hoshangabaad	होशंगाबाद	होशंगाबाद	pred_true
hoshangabad	होशंगाबाद	होशंगाबाद	pred_true
hostes	होस्टेस	होस्टेस	pred_true
hostess	होस्टेस	होस्टेस	pred_true
