src	target	pred	status
ank	अंक	अंक	pred_true
anka	अंक	अंका	pred_false
ankit	अंकित	अंकित	pred_true
anakon	अंकों	आनकों	pred_false
ankhon	अंकों	अंखों	pred_false
ankon	अंकों	अंकों	pred_true
angkor	अंकोर	एंकोड	pred_false
ankor	अंकोर	एंकोर	pred_false
angaarak	अंगारक	अंगारक	pred_true
angarak	अंगारक	अंगरक	pred_false
angraji	अंग्रज़ी	अंग्रज	pred_false
angreji	अंग्रज़ी	अंग्रेजी	pred_false
angrzi	अंग्रज़ी	अंग्री	pred_false
antah	अंतः	अंतह	pred_false
antaha	अंतः	अंतहा	pred_false
antarmukh	अंतर्मुख	अंतरमुख	pred_false
antmurkh	अंतर्मुख	अंतमूर्ख	pred_false
antrmukh	अंतर्मुख	अंतरमखुख	pred_false
andrabee	अंद्राबी	अंदरबी	pred_false
andrabi	अंद्राबी	अंदरबी	pred_false
andha	अंधा	अंधा	pred_true
andhapan	अंधापन	अंधापन	pred_true
andheri	अंधेरी	अंधेरी	pred_true
ambaani	अंबानी	अंबानी	pred_true
ambani	अंबानी	अंबानी	pred_true
akram	अकरम	आक्रम	pred_false
acapulco	अकापुल्को	अकापुल्को	pred_true
akapulko	अकापुल्को	अकपूलकों	pred_false
akhand	अखंड	अखंद	pred_false
akhil	अखिल	अखिल	pred_true
agavai	अगवाई	अगवाई	pred_true
agvaai	अगवाई	अग्वाई	pred_false
augustine	अगस्टाइन	ऑगस्टीन	pred_false
augustustine	अगस्टाइन	ऑगस्ट्सूटन	pred_false
agsta	अगस्ता	अगस्ता	pred_true
agusta	अगस्ता	अगुस्त	pred_false
augusta	अगस्ता	औगसस्त	pred_false
agr	अग्र	अग्र	pred_true
agra	अग्र	आगरा	pred_false
achambha	अचंभा	अचंभा	pred_true
achanbha	अचंभा	अचांभा	pred_false
achievement	अचीवमेंट	अयीशवेमंट	pred_false
achivement	अचीवमेंट	अचिवेमेंट	pred_false
acchi	अच्छी	अछ्ी	pred_false
achchi	अच्छी	अछ्छी	pred_false
achhi	अच्छी	अछी	pred_false
achyut	अच्युत	अछूत	pred_false
achhanera	अछनेरा	अछानेरा	pred_false
achnera	अछनेरा	अचनरा	pred_false
ajmeedh	अजमीढ़	अजमीद	pred_false
ajhar	अजहर	अजर	pred_false
azhar	अजहर	अजरर	pred_false
ajit	अजित	अजीत	pred_false
agnat	अज्ञात	अग्ञात	pred_false
agyaat	अज्ञात	अज्ञात	pred_true
agyat	अज्ञात	अज्ञात	pred_true
atakta	अटकता	अतकता	pred_false
atkata	अटकता	अत्कता	pred_false
atake	अटके	अटक	pred_false
atke	अटके	अटके	pred_true
atwaal	अटवाल	अतवाल	pred_false
atwal	अटवाल	अटवाल	pred_true
attahasa	अट्टहास	अत्हासा	pred_false
atthaas	अट्टहास	अत्थास	pred_false
atthas	अट्टहास	अत्थास	pred_false
addon	अड्डों	अड्डों	pred_true
athak	अथक	अथक	pred_true
atharv	अथर्व	अथर्व	pred_true
atharva	अथर्व	अथर्व	pred_true
adad	अदद	अदाद	pred_false
adaani	अदाणी	अदानी	pred_false
adani	अदाणी	अदनी	pred_false
advait	अद्वैत	अदवाइत	pred_false
adwait	अद्वैत	अदवाइत	pred_false
advaitvaad	अद्वैतवाद	अद्वैतवाद	pred_true
advaitwad	अद्वैतवाद	अद्वैतवाद	pred_true
adhivas	अधिवास	अधिवास	pred_true
adhiwas	अधिवास	अधिवास	pred_true
advivas	अधिवास	अदविवास	pred_false
adhiik	अधीक	अधिक	pred_false
adhik	अधीक	अधिक	pred_false
adhyayanarat	अध्ययनरत	अध्ययनररत	pred_false
adhyayanrat	अध्ययनरत	अध्ययन्रत	pred_false
adhyaynrat	अध्ययनरत	अध्ययन्त	pred_false
anant	अनंत	अनंत	pred_true
ananti	अनंती	अनाती	pred_false
angadh	अनगढ़	अंगढ़	pred_false
angarh	अनगढ़	अंगर	pred_false
anchahe	अनचाहे	अंछाहे	pred_false
anthak	अनथक	अंथक	pred_false
unthak	अनथक	उंठक	pred_false
anhoni	अनहोनी	अन्होंी	pred_false
anaavashyak	अनावश्यक	अनावश्यक	pred_true
anavashyak	अनावश्यक	अनावश्यक	pred_true
anavshyak	अनावश्यक	अनावश्यक	pred_true
anawashyak	अनावश्यक	अनावश्यक	pred_true
anik	अनिक	अनिक	pred_true
anishwarvadi	अनीश्वरवादी	अनिश्वर्वादी	pred_false
anishwarwadi	अनीश्वरवादी	अनिश्वर्वादी	pred_false
anukoltha	अनुकूलता	अनुकोल्था	pred_false
anukulata	अनुकूलता	अनुकुलता	pred_false
anukulta	अनुकूलता	अनुकुलता	pred_false
anuchit	अनुचित	अनुचित	pred_true
anuprayogi	अनुप्रयोगों	अनुप्रयोगी	pred_false
anuprayogon	अनुप्रयोगों	अनुप्रयोग	pred_false
anupryogon	अनुप्रयोगों	अनुप्योगों	pred_false
anureet	अनुरीत	अनुरीत	pred_true
anurit	अनुरीत	अनुरीत	pred_true
anuthi	अनूठी	अनुथी	pred_false
anudit	अनूदित	अनुदीत	pred_false
anyaay	अन्याय	अन्याय	pred_true
anyay	अन्याय	अन्य	pred_false
anyaya	अन्याय	अन्या	pred_false
apnani	अपनानी	अपनानी	pred_true
aparivartanshali	अपरिवर्तनशील	अपरिवारताशा	pred_false
aparivartansheel	अपरिवर्तनशील	अपरिवर्तनशील	pred_true
aparivartanshil	अपरिवर्तनशील	अपरिवर्तनशील	pred_true
apariharya	अपरिहार्य	अपरहहार्य	pred_false
aprihary	अपरिहार्य	अप्रहर्य	pred_false
apriyary	अपरिहार्य	अप्रिय	pred_false
apavartit	अपवर्तित	अपवर्तित	pred_true
apvartit	अपवर्तित	अपवर्तित	pred_true
apvtrit	अपवर्तित	अपवत्रित	pred_false
apaardarshi	अपारदर्शी	अपरदर्शी	pred_false
apardarshi	अपारदर्शी	अपरदर्शी	pred_false
afroj	अफरोज	अफरोज	pred_true
afroz	अफरोज	अफ्रोज	pred_false
africa	अफ्रीका	अफ्रिका	pred_false
abbaasi	अब्बासी	अब्बासी	pred_true
abbasi	अब्बासी	अब्बासी	pred_true
abhimat	अभिमत	अभिमत	pred_true
abhishap	अभिशाप	अभिषाप	pred_false
abhi	अभी	अभी	pred_true
amjhera	अमझेरा	अमझरा	pred_false
amzera	अमझेरा	अमजेरा	pred_false
amargad	अमरगढ़	अमरगद	pred_false
amargarh	अमरगढ़	अमरगढ़	pred_true
amarpaal	अमरपाल	अमररपाल	pred_false
amarpal	अमरपाल	अमररपल	pred_false
amarohi	अमरोही	अमारोही	pred_false
amrohi	अमरोही	अमरोही	pred_true
amaanat	अमानत	अमानत	pred_true
amanat	अमानत	अमानत	pred_true
amanth	अमानत	अमांठ	pred_false
amaanati	अमानती	अमानती	pred_true
amanathi	अमानती	अमानाथी	pred_false
amanati	अमानती	अमानती	pred_true
amavasya	अमावस्या	अमववस्य	pred_false
amavsya	अमावस्या	अमववस्य	pred_false
amit	अमित	अमीत	pred_false
amitao	अमिताव	अमिताओ	pred_false
amitav	अमिताव	अमितव	pred_false
amuk	अमुक	अमूक	pred_false
amogh	अमोघ	अमोग	pred_false
ambani	अम्बानी	अंबानी	pred_false
ayodhyaanaath	अयोध्यानाथ	अयोध्यानाथ	pred_true
ayodhyanaath	अयोध्यानाथ	अयोध्यनाथ	pred_false
ayodhyanath	अयोध्यानाथ	अयोध्यनाथ	pred_false
ayodhyeanath	अयोध्यानाथ	अयोध्यान	pred_false
aradas	अरदास	अरदास	pred_true
ardaas	अरदास	अर्दास	pred_false
ardas	अरदास	अर्दास	pred_false
arabab	अरबाब	अरबब	pred_false
arbab	अरबाब	अरबब	pred_false
around	अराउंड	अराउंड	pred_true
arjent	अर्जेंट	अर्जेंट	pred_true
urgent	अर्जेंट	यूर्जेंट	pred_false
arth	अर्थ	आर्थ	pred_false
artha	अर्थ	अर्थ	pred_true
earth	अर्थ	अर्थ	pred_true
earthquake	अर्थक्वेक	इय्थकवाक	pred_false
arthon	अर्थों	आर्थों	pred_false
arpit	अर्पित	अर्पित	pred_true
aryama	अर्यमा	अर्यमा	pred_true
aryma	अर्यमा	आर्यमा	pred_false
arymaa	अर्यमा	अर्यमा	pred_true
alankaar	अलंकार	अलंकार	pred_true
alankar	अलंकार	अलंकर	pred_false
alnkaar	अलंकार	अलंकार	pred_true
alankaaron	अलंकारों	अलंकारों	pred_true
alankaron	अलंकारों	अलंकारों	pred_true
alnkaaron	अलंकारों	अलंकारों	pred_true
alnkaron	अलंकारों	अलंकारों	pred_true
alagavavadi	अलगाववादी	अलगगवादी	pred_false
algavvadi	अलगाववादी	अल्गववादी	pred_false
algavwaadi	अलगाववादी	अल्गववादी	pred_false
alive	अलाइव	एलीव	pred_false
alance	अलायंस	एलांस	pred_false
alayans	अलायंस	अलायंस	pred_true
aliance	अलायंस	एलियंस	pred_false
alind	अलिंद	अलिंड	pred_false
alai	अली	अलाई	pred_false
ali	अली	अली	pred_true
alii	अली	अली	pred_true
alonso	अलोंसो	एलोंसो	pred_false
aloso	अलोंसो	एलोसो	pred_false
alphabet	अल्फ़ाबेट	अल्फेबेट	pred_false
alba	अल्बा	अलबा	pred_false
avantipur	अवंतिपुर	अवंतीपुर	pred_false
awantipora	अवंतिपुर	अवंतिपोरा	pred_false
avaru	अवरु	आवारू	pred_false
avru	अवरु	अवृ	pred_false
awaru	अवरु	आवारू	pred_false
avarodhak	अवरोधक	अवरोधक	pred_true
avrodhak	अवरोधक	अवरोधक	pred_true
avrodhk	अवरोधक	अवरोधक	pred_true
avarnata	अवर्णता	अवरणता	pred_false
avarnataa	अवर्णता	अवरणता	pred_false
avranta	अवर्णता	अवरंता	pred_false
avashist	अवशिष्ट	अवशिष्ट	pred_true
avshisht	अवशिष्ट	अवशिष्ट	pred_true
awashist	अवशिष्ट	अवशिष्ट	pred_true
avasthaayen	अवस्थाएं	अवस्थाएं	pred_true
avsthaen	अवस्थाएं	अवस्थाएं	pred_true
avsthayen	अवस्थाएं	अवस्थाएं	pred_true
awasthaen	अवस्थाएं	अवस्थाएं	pred_true
avi	अवि	एवी	pred_false
avika	अविका	अविका	pred_true
aviral	अविरल	अविराल	pred_false
avirl	अविरल	अविरल	pred_true
avishvaasniy	अविश्वसनीय	अविश्वासीय	pred_false
avishvasniy	अविश्वसनीय	अविश्वानीय	pred_false
avishvasniya	अविश्वसनीय	अविश्वानीय	pred_false
avisvasniya	अविश्वसनीय	अविस्वानीय	pred_false
aviva	अवीवा	अविवा	pred_false
avaigyanic	अवैज्ञानिक	अवैज्ञानिक	pred_true
avaigyanik	अवैज्ञानिक	अवैज्ञानिक	pred_true
avegyanik	अवैज्ञानिक	अवेज्ञानिक	pred_false
ashaktataa	अशक्तता	अशक्तता	pred_true
ashktta	अशक्तता	अशक्तता	pred_true
asharaphi	अशरफी	अशररफी	pred_false
ashrafi	अशरफी	अश्रफी	pred_false
ashariri	अशरीरी	अशरीरी	pred_true
ashriri	अशरीरी	अश्रीरी	pred_false
ashrvatath	अश्वत्थ	अश्रवताथ	pred_false
ashvtth	अश्वत्थ	अश्वत्थ	pred_true
asamaany	असमान्य	असमान्य	pred_true
asamany	असमान्य	असामान्य	pred_false
asmanye	असमान्य	असमान्य	pred_true
asaamnjsy	असामंजस्य	असामंज्य	pred_false
asamanjasy	असामंजस्य	असमंजस्य	pred_false
asamanjasya	असामंजस्य	असमंजस्य	pred_false
asurakshit	असुरक्षित	असुरक्षित	pred_true
asurkshit	असुरक्षित	असुरक्षित	pred_true
aset	असेट	एसेट	pred_false
asset	असेट	एसेट	pred_false
asvabhavik	अस्वभाविक	अस्वाभािक	pred_false
aswabhavik	अस्वभाविक	अस्वाभािक	pred_false
aswbhavik	अस्वभाविक	अस्वभाविक	pred_true
ahirauli	अहिरौली	अहिरौली	pred_true
item	आइटम	आईटम	pred_false
items	आइटम्स	आईटेम्स	pred_false
idle	आइडल	आइडल	pred_true
idol	आइडल	आइडल	pred_true
icc	आइसीसी	आईसीसी	pred_false
iso	आइसो	आईसो	pred_false
ipc	आईपीसी	आईपीसी	pred_true
ipad	आईपैड	इपाद	pred_false
iris	आईरिस	आइरिस	pred_false
ounce	आउंस	आंस	pred_false
aakaash	आकाश	आकाश	pred_true
aakash	आकाश	आकाश	pred_true
aake	आके	आके	pred_true
aakhet	आखेट	आखेत	pred_false
akhet	आखेट	अखेत	pred_false
aagat	आगत	आगत	pred_true
aagaman	आगमन	आगममन	pred_false
aagman	आगमन	आगमान	pred_false
aagaa	आग़ा	आगा	pred_false
aagah	आग़ा	आगाह	pred_false
agha	आग़ा	आघा	pred_false
aagaashe	आगाशे	आगाशे	pred_true
aagashe	आगाशे	आगशे	pred_false
agashe	आगाशे	अगशश	pred_false
aajmaanaa	आजमाना	आजमाना	pred_true
aajmana	आजमाना	आजमाना	pred_true
aazmaanaa	आजमाना	आजमाना	pred_true
aata	आटा	आता	pred_false
ata	आटा	आता	pred_false
atta	आटा	अट्टा	pred_false
aatmayen	आत्माएं	आत्माएं	pred_true
atmaen	आत्माएं	अतमाएं	pred_false
aadaan	आदान	आदान	pred_true
aadan	आदान	आदान	pred_true
aadhaarit	आधारित	आधारित	pred_true
aadharit	आधारित	आधारित	pred_true
adharit	आधारित	अधारित	pred_false
aadheen	आधीन	आधीन	pred_true
aadhin	आधीन	आधीन	pred_true
aadhunik	आधुनिक	आधुनिक	pred_true
aanad	आनद	आनद	pred_true
aanand	आनद	आनंद	pred_false
anand	आनद	अनंद	pred_false
aapka	आपका	आपका	pred_true
aapkaa	आपका	आपका	pred_true
aapadaaaen	आपदाएं	आपदाएं	pred_true
aapdaein	आपदाएं	आपदाएं	pred_true
aapdayein	आपदाएं	आपदाएं	pred_true
aabantit	आबंटित	आबंतित	pred_false
abantit	आबंटित	अबंतित	pred_false
aabru	आबरू	आबृू	pred_false
abaru	आबरू	अबारू	pred_false
aamdan	आमदन	आमदान	pred_false
amadan	आमदन	अमादन	pred_false
aamdani	आमदनी	आमदानी	pred_false
amadani	आमदनी	अमादनी	pred_false
aamdi	आमदी	आमड़ी	pred_false
amdi	आमदी	आमड़ी	pred_false
aamod	आमोद	आमोद	pred_true
amod	आमोद	अमोद	pred_false
aayenge	आयेंगे	आएंगे	pred_false
aayojak	आयोजक	आयोजक	pred_true
ro	आरओ	रो	pred_false
rp	आरपी	आरपी	pred_true
aaraam	आराम	आराम	pred_true
aaram	आराम	आरम	pred_false
aram	आराम	आरम	pred_false
aarushi	आरुषि	आरुशी	pred_false
arushi	आरुषि	अरुशी	pred_false
artery	आर्टरी	आर्टी	pred_false
order	आर्डर	ऑर्डर	pred_false
aary	आर्य	आरी	pred_false
aarya	आर्य	आर्य	pred_true
arya	आर्य	आर्य	pred_true
aaryika	आर्यिका	आर्यिका	pred_true
aryika	आर्यिका	अर्यिका	pred_false
aarya	आर्यो	आर्य	pred_false
arya	आर्यो	आर्य	pred_false
aryo	आर्यो	आर्यो	pred_true
aaryan	आर्यों	आर्यान	pred_false
arya	आर्यों	आर्य	pred_false
aryon	आर्यों	आर्यों	pred_true
aalsi	आलसी	आलसी	pred_true
alasi	आलसी	अलासी	pred_false
aalochak	आलोचक	आलोचक	pred_true
alochak	आलोचक	अलोचक	pred_false
aalochakon	आलोचकों	आलोचकों	pred_true
alochakon	आलोचकों	अलोचकों	pred_false
aalha	आल्हा	आल्हा	pred_true
aalhaa	आल्हा	आल्हा	pred_true
alha	आल्हा	अल्हा	pred_false
allah	आल्हा	अल्लाह	pred_false
aawaazen	आवाज़ें	आवाजें	pred_false
aawajen	आवाज़ें	आवाजें	pred_false
awaazen	आवाज़ें	अवाजें	pred_false
awazen	आवाज़ें	अवाजें	pred_false
aawajon	आवाज़ों	आवाजों	pred_false
aawazon	आवाज़ों	आवाजों	pred_false
awaazon	आवाज़ों	आवाजों	pred_false
awazon	आवाज़ों	आवाजों	pred_false
aavishakaar	आविष्कार	आविषाकार	pred_false
aavishkaar	आविष्कार	आविष्कार	pred_true
avishkar	आविष्कार	अविष्कार	pred_false
aavriti	आवृत्ति	आवृति	pred_false
aavritti	आवृत्ति	आवृत्ति	pred_true
avuti	आवृत्ति	अवुती	pred_false
aavritiyon	आवृत्तियों	आवृतियों	pred_false
aavrittiyon	आवृत्तियों	आवृत्तियों	pred_true
avrutiyon	आवृत्तियों	अवृतियों	pred_false
aashanka	आशंका	आशंका	pred_true
ashanka	आशंका	अशंका	pred_false
aashriton	आश्रितों	आश्रितों	pred_true
ashriton	आश्रितों	अश्रोतों	pred_false
aasaan	आसान	आसान	pred_true
aasan	आसान	आसन	pred_false
asan	आसान	असन	pred_false
aastik	आस्तिक	आस्तिक	pred_true
astik	आस्तिक	अस्तिक	pred_false
aasteen	आस्तीन	आस्तीन	pred_true
aastin	आस्तीन	आस्तिन	pred_false
astin	आस्तीन	एस्टिन	pred_false
aahnaan	आह्नान	आहनन	pred_false
aahnan	आह्नान	आहनन	pred_false
ahyan	आह्नान	अह्यान	pred_false
england	इंग्लैंड	एंग्लैंड	pred_false
engineer	इंजिनियर	एंजीनियर	pred_false
introduction	इंट्रोडक्शन	इंट्रोडक्शन	pred_true
insurance	इंश्योरेंस	इंसररंस	pred_false
ear	इअर	ईयर	pred_false
eyer	इअर	ईयर	pred_false
eon	इआन	इयोन	pred_false
iaan	इआन	इयान	pred_false
ekattha	इकट्ठा	इक्ट्ठा	pred_false
ikattha	इकट्ठा	इक्त्ठा	pred_false
ekatthi	इकठ्ठी	इकत्ठी	pred_false
ekthi	इकठ्ठी	एकत्ठी	pred_false
ikatthi	इकठ्ठी	इकट्ठी	pred_false
ekaee	इकाई	ईकाई	pred_false
ikai	इकाई	ईकाई	pred_false
ekaeyon	इकाईयों	इकाइयों	pred_false
ikaiyon	इकाईयों	इकाइयों	pred_false
ikarion	इकाईयों	इकारियों	pred_false
economic	इकोनोमिक	इकॉनॉमिक	pred_false
ecuador	इक्वाडोर	एक्यूडोर	pred_false
equador	इक्वाडोर	एक्वाउडोर	pred_false
equities	इक्विटीज	एक्वीटीज	pred_false
ikvitija	इक्विटीज	इक्वितिज	pred_false
ijaajat	इजाजत	इजाज़त	pred_false
ijajat	इजाजत	इज़ाजत	pred_false
inhalation	इनहेलेशन	इन्हालिशन	pred_false
inhaletion	इनहेलेशन	इन्हालेशन	pred_false
ibija	इबीजा	इबिजा	pred_false
ibiza	इबीजा	इबिजा	pred_false
imaging	इमेजिंग	इइग्गिंग	pred_false
immune	इम्युन	इम्यून	pred_false
elaichi	इलाइची	इलैची	pred_false
ilaichi	इलाइची	इलैची	pred_false
ilayachi	इलाइची	इलायची	pred_false
ilayichi	इलाइची	इलायिची	pred_false
elaaj	इलाज	इलाज	pred_true
ilaaj	इलाज	इलाज	pred_true
ilaj	इलाज	इलााज	pred_false
ishaak	इशाक	इशाक	pred_true
ishaaq	इशाक	इशाक	pred_true
ishak	इशाक	इशा	pred_false
ishaara	इशारा	इशारा	pred_true
ishaaraa	इशारा	इशारा	pred_true
ishara	इशारा	इशारा	pred_true
ishita	इशिता	इशिता	pred_true
isht	इष्ट	आश्ट	pred_false
isteefe	इस्तीफे	इस्टीफ	pred_false
istife	इस्तीफे	इस्टाफफ	pred_false
ea	ईए	ईए	pred_true
ia	ईए	आय	pred_false
eater	ईटर	आटीटर	pred_false
iter	ईटर	आइटर	pred_false
email	ईमेल	एमैल	pred_false
emailon	ईमेलों	एमैलों	pred_false
emelon	ईमेलों	एमलों	pred_false
evening	ईवनिंग	एवेनिंग	pred_false
east	ईष्ट	ईस्ट	pred_false
ishat	ईष्ट	इशा	pred_false
isht	ईष्ट	आश्ट	pred_false
isaaiyon	ईसाइयों	ईसाईयों	pred_false
isaiyon	ईसाइयों	ईसाईयों	pred_false
isayiyon	ईसाइयों	ईसाईयों	pred_false
ikhrul	उखरुल	इखरूल	pred_false
ukhrool	उखरुल	उखरूल	pred_false
ukhrul	उखरुल	उखरूल	pred_false
uchhalane	उछालने	उछलने	pred_false
uchhalne	उछालने	उछलने	pred_false
ujback	उज़्बेक	उजबेक	pred_false
uzbek	उज़्बेक	उज़बेक	pred_false
uthane	उठने	उठाने	pred_false
uthne	उठने	उठनने	pred_false
uthaakar	उठाकर	उथाकर	pred_false
uthakar	उठाकर	उथाकर	pred_false
uthaapatak	उठापटक	उथापत	pred_false
uthapatak	उठापटक	उथापकत	pred_false
uthen	उठें	उठें	pred_true
udaan	उड़ान	उदान	pred_false
udan	उड़ान	उदान	pred_false
udaanaa	उड़ाना	उदाना	pred_false
udana	उड़ाना	उड़ना	pred_false
udaane	उड़ाने	उड़ने	pred_false
udane	उड़ाने	उड़ने	pred_false
udaanen	उड़ानें	उदानें	pred_false
udanen	उड़ानें	उदानें	pred_false
udaanon	उड़ानों	उदानों	pred_false
udanon	उड़ानों	उदानों	pred_false
utane	उतने	उतने	pred_true
utaney	उतने	उतने	pred_true
utne	उतने	उतने	pred_true
uttara	उत्तरा	उत्तारा	pred_false
uttra	उत्तरा	उत्तरा	pred_true
utpan	उत्पन	उत्पान	pred_false
udant	उदंत	उदंत	pred_true
udghosh	उदघोष	उद्घोष	pred_false
udar	उदर	उदार	pred_false
uda	उदा	उड़ा	pred_false
udaa	उदा	उड़ा	pred_false
udakishuganj	उदाकिशुनगंज	उद़किषुगंज	pred_false
udakishunganj	उदाकिशुनगंज	उद़किषंग	pred_false
unatees	उनतीस	उन्तीस	pred_false
untees	उनतीस	उंटीस	pred_false
uniyal	उनियाल	यूनियल	pred_false
upadraviyon	उपद्रवियों	उपद्रवियों	pred_true
updravion	उपद्रवियों	उप्र्वियन	pred_false
updraviyon	उपद्रवियों	उपद्रवियों	pred_true
upadravi	उपद्रवी	उपद्रवी	pred_true
updravi	उपद्रवी	उपद्रवी	pred_true
upadrawon	उपद्रवों	उपद्रवों	pred_true
updravon	उपद्रवों	उपद्रवों	pred_true
upneta	उपनेता	उपनेता	pred_true
upabhokta	उपभोक्ता	उपभोक्त	pred_false
upbhokta	उपभोक्ता	उपभोक्त	pred_false
uplaksh	उपलक्ष्य	उपलक्ष	pred_false
uplakshay	उपलक्ष्य	उप्लक्षय	pred_false
uplakshya	उपलक्ष्य	उपलाक्ष्य	pred_false
uplabdh	उपलब्ध	उपलब्ध	pred_true
uplabdhiyon	उपलब्धियों	उपलब्धियों	pred_true
uplabdhi	उपलब्धी	उपलाब्धि	pred_false
upakhyaanon	उपाख्यानों	उपख्यानों	pred_false
upakhyanon	उपाख्यानों	उपख्यानों	pred_false
ubuntu	उबंटू	उबुंतु	pred_false
ubaal	उबाल	उबाल	pred_true
ubal	उबाल	उबाल	pred_true
ubhaara	उभारा	उभारा	pred_true
ubhara	उभारा	उभरा	pred_false
umanath	उमानाथ	उमानाथ	pred_true
umesh	उमेश	उम्ेश	pred_false
urf	उर्फ	उर्फ	pred_true
urfa	उर्फ	उरफा	pred_false
urff	उर्फ	यूफफ	pred_false
urvarakon	उर्वरकों	उर्वारों	pred_false
urvarkon	उर्वरकों	उर्वारकों	pred_false
urwarakon	उर्वरकों	उर्वारों	pred_false
urvarata	उर्वरता	उर्वरता	pred_true
urvarta	उर्वरता	उर्वर्ता	pred_false
urwarta	उर्वरता	उर्वर्त	pred_false
ulate	उलटे	उलते	pred_false
ulte	उलटे	उलते	pred_false
ulahana	उलाहना	उलहना	pred_false
ulahna	उलाहना	उलहना	pred_false
ulema	उलेमा	उलेमा	pred_true
ulemaon	उलेमाओं	उलेमाओं	pred_true
usak	उसक	उसक	pred_true
usaki	उसकी	उसकी	pred_true
uski	उसकी	उसकी	pred_true
usmein	उसमें	उसमें	pred_true
usmen	उसमें	उसमें	pred_true
usi	उसी	उसी	pred_true
ustara	उस्तरा	उस्तरा	pred_true
udharv	ऊर्ध्व	उधर्व	pred_false
udhrva	ऊर्ध्व	उध्रवा	pred_false
urdhav	ऊर्ध्व	उर्धव	pred_false
ushma	ऊष्मा	उषमा	pred_false
rishicool	ऋषिकुल	रिशूकूल	pred_false
rishikul	ऋषिकुल	ऋशिकुल	pred_false
rushikul	ऋषिकुल	ऋषिकुल	pred_true
enzyme	एंजाइम	एंजीम	pred_false
anton	एंटोन	एंटन	pred_false
entone	एंटोन	एंटोन	pred_true
antoni	एंटोनी	अंटोनी	pred_false
antony	एंटोनी	एंटनी	pred_false
endometrial	एंडोमेट्रियल	एंडोमेमटियल	pred_false
andreas	एंड्रियास	एंड्रेस	pred_false
als	एएलएस	एल्स	pred_false
asi	एएसआई	एसी	pred_false
eksaath	एकसाथ	एकस्थाथ	pred_false
eksath	एकसाथ	एकस्थ	pred_false
ekaki	एकाकी	एकाकी	pred_true
xm	एक्सएम	एक्मसीएम	pred_false
egmor	एगमोर	एगमोर	pred_true
egmore	एगमोर	एगमोर	pred_true
aj	एजे	अज	pred_false
agende	एजेंडे	एगेंडे	pred_false
adp	एडीपी	एडीपी	pred_true
adain	एडेन	अड़ाइन	pred_false
aden	एडेन	अड़ेन	pred_false
edan	एडेन	एडन	pred_false
addi	एड्डी	आड़ी	pred_false
eddi	एड्डी	एडीडी	pred_false
eddie	एड्डी	एडी	pred_false
eddy	एड्डी	एडीडी	pred_false
apj	एपीजे	अपज	pred_false
ftii	एफटीआईआई	फ्टिए	pred_false
abbott	एबट	अब्बोत	pred_false
abut	एबट	अबुत	pred_false
ebt	एबट	एब्टी	pred_false
abvp	एबीवीपी	एब्वीपी	pred_false
abbot	एबोट	अब्बोत	pred_false
abbott	एबोट	अब्बोत	pred_false
mta	एमटीए	मता	pred_false
mtake	एमटेक	मटकक	pred_false
mtec	एमटेक	मेटक	pred_false
mtech	एमटेक	मैक	pred_false
emerald	एमरल्ड	एमरल्ड	pred_true
emrald	एमरल्ड	एमराल्ड	pred_false
emil	एमिल	एमिल	pred_true
emile	एमिल	एमीले	pred_false
emily	एमिल	एमिली	pred_false
amy	एमी	अम्य	pred_false
emi	एमी	एमी	pred_true
airway	एयरवे	एररे	pred_false
eyarave	एयरवे	एयरवे	pred_true
eyarve	एयरवे	एयरव	pred_false
error	एरर	एरोर	pred_false
arica	एरिका	आरिका	pred_false
erica	एरिका	एरिका	pred_true
erika	एरिका	एरिका	pred_true
aerobic	एरोबिक	एरोबिक	pred_true
aerobics	एरोबिक	एरोबिक्स	pred_false
lte	एलटीई	लते	pred_false
lti	एलटीई	लती	pred_false
allergic	एलर्जिक	एलर्गिक	pred_false
eliminator	एलिमिनेटर	एलिमीनेटर	pred_false
aliens	एलियंस	एलिंस	pred_false
alliance	एलियंस	एलियंस	pred_true
asian	एशियन	एशियां	pred_false
sfc	एसएफसी	एसएससी	pred_false
sk	एसके	एसक्स	pred_false
spf	एसपीएफ	एसपीएफफी	pred_false
association	एसोसिएशन	एसोसिएशन	pred_true
astar	एस्टर	अस्तर	pred_false
aster	एस्टर	अस्टर	pred_false
ester	एस्टर	एस्टर	pred_true
aesthetics	एस्थेटिक	एस्थेटिक्स	pred_false
asthetic	एस्थेटिक	एस्थेटिक	pred_true
asfalt	एस्फाल्ट	अस्फल	pred_false
asphalt	एस्फाल्ट	अस्फलल्ट	pred_false
asphault	एस्फाल्ट	अस्फौल्ट	pred_false
ahsaas	एहसास	अहसास	pred_false
ehsaas	एहसास	इहसास	pred_false
ehsas	एहसास	एहसास	pred_true
aisa	एेसा	एसा	pred_false
eesa	एेसा	ईसा	pred_false
ainth	ऐंठ	ऐंठ	pred_true
end	ऐंठ	ऐंड	pred_false
enth	ऐंठ	ऐंठ	pred_true
ainthey	ऐंठे	ऐंठे	pred_true
enthe	ऐंठे	ईंठ	pred_false
aithan	ऐठन	ऐंठन	pred_false
ethan	ऐठन	ऐथन	pred_false
ethhan	ऐठन	ऐथन	pred_false
ail	ऐल	एल	pred_false
el	ऐल	एल	pred_false
alaps	ऐल्प्स	अलापस	pred_false
alps	ऐल्प्स	एल्प्स	pred_false
aise	ऐसे	ऐस	pred_false
oxide	ऑक्साइड	ऑक्साइड	pred_true
oxy	ऑक्सी	ओक्सी	pred_false
offers	ऑफर्स	ऑफर्स	pred_true
offshor	ऑफशोर	ऑफशर	pred_false
offshore	ऑफशोर	ऑफ्शोर	pred_false
official	ऑफिशियल	ऑफिसियल	pred_false
okalahoma	ओकलाहोमा	ओकलाहोमा	pred_true
oklahoma	ओकलाहोमा	ओकलाहोमा	pred_true
oklahoma	ओक्लाहोमा	ओकलाहोमा	pred_false
ot	ओत	ओटी	pred_false
opel	ओपेल	ओपेल	pred_true
obrayan	ओब्रायन	ओब्रायन	pred_true
obrien	ओब्रायन	ऑब्रियन	pred_false
oran	ओरण	ओरान	pred_false
orian	ओरियन	ओरियन	pred_true
orion	ओरियन	ओरियन	pred_true
olavrishti	ओलावृष्टि	उलावृष्टि	pred_false
ovum	ओवम	ओवुम	pred_false
owem	ओवम	ओवम	pred_true
oceanic	ओशनिक	ओकेनिक	pred_false
osaka	ओसाका	ओसका	pred_false
auchity	औचित्य	अचित्य	pred_false
auchitya	औचित्य	औचित्य	pred_true
audhyogikaran	औद्योगिकरण	औध्योगकरण	pred_false
audyogikarana	औद्योगिकरण	उद्योगिकरण	pred_false
audyogikikaran	औद्योगिकरण	आद्योगिकरण	pred_false
aurangabad	औरंगाबाद	औरंगाबाद	pred_true
aurora	औरोरा	औौरो	pred_false
aulakh	औलख	औलख	pred_true
kankad	कंकड़	कंकड़	pred_true
kankar	कंकड़	कंकर	pred_false
kankad	कंकर	कंकड़	pred_false
kankar	कंकर	कंकर	pred_true
kangan	कंगन	कंगण	pred_false
conjunction	कंजंक्शन	कंजन्शन	pred_false
contemporary	कंटेम्पररी	कंटेमोपररी	pred_false
kanthahar	कंठहार	कंथहर	pred_false
kanthhar	कंठहार	कंथहर	pred_false
composer	कंपोजर	कंपोसर	pred_false
kambalon	कंबलों	कंबलों	pred_true
kanblon	कंबलों	कंबलों	pred_true
consultant	कंसलटेंट	कंसुल्टेंट	pred_false
kakkad	कक्कड़	कक्कड़	pred_true
kakkar	कक्कड़	कक्कर	pred_false
kacche	कच्चे	कच्चे	pred_true
kachche	कच्चे	कच्चे	pred_true
karta	कटरा	कार्टा	pred_false
katra	कटरा	कत्र	pred_false
cutlery	कटलरी	कटली	pred_false
katlari	कटलरी	कटलारी	pred_false
katlary	कटलरी	कालारी	pred_false
katasaraj	कटासराज	कतससरज	pred_false
kathfodave	कठफोड़वे	कथफोड़ावे	pred_false
kathfodve	कठफोड़वे	कथफोड़वे	pred_false
kathor	कठोर	कथोर	pred_false
kathore	कठोर	कथोरे	pred_false
kanika	कणिका	काणिका	pred_false
kathai	कत्थई	कथाई	pred_false
katthai	कत्थई	कट्थाई	pred_false
katthaii	कत्थई	कट्ईयाई	pred_false
convention	कनवेंशन	कन्वेशन	pred_false
canals	कनाल	कैनल्स	pred_false
kanaal	कनाल	कनाल	pred_true
kanal	कनाल	कनाल	pred_true
kanindham	कनिंघम	कनिंदम	pred_false
kaningham	कनिंघम	कनिंघम	pred_true
kanishthika	कनिष्ठिका	काणिष्ठिका	pred_false
kanishthikaa	कनिष्ठिका	कनिष्ठिका	pred_true
kanishtika	कनिष्ठिका	काणिष्टिका	pred_false
kanyaayen	कन्याएं	कन्याएं	pred_true
kanyaein	कन्याएं	कन्याएं	pred_true
kanyayen	कन्याएं	का्याएं	pred_false
convention	कन्वेंशन	कन्वेशन	pred_false
convocation	कन्वोकेशन	कन्वोकेशन	pred_true
cup	कप	कूप	pred_false
kap	कप	कप	pred_true
kapda	कपड़ा	कपड़ा	pred_true
kpada	कपड़ा	कपाड़ा	pred_false
kapdo	कपड़ो	कपड़ो	pred_true
kapdon	कपड़ो	कपड़ों	pred_false
kaping	कपिंग	कपपिंग	pred_false
kping	कपिंग	कपिंग	pred_true
kapolkalpana	कपोलकल्पना	कपोलकल्पना	pred_true
kabaddi	कबड्डी	कबड़ड़ी	pred_false
kabr	कब्र	कब्ब	pred_false
kabra	कब्र	कब्र	pred_true
kabren	कब्रें	कबरें	pred_false
kabron	कब्रों	कब्रों	pred_true
kamjor	कमज़ोर	कमजोर	pred_false
kamzor	कमज़ोर	कमजोर	pred_false
kamatar	कमतर	कमटर	pred_false
kamtar	कमतर	कमटर	pred_false
kalamjeet	कमलजीत	कलमजीत	pred_false
kamaljeet	कमलजीत	कमलजीत	pred_true
kamaauu	कमाऊ	कमाऊ	pred_true
kamau	कमाऊ	कमौ	pred_false
kamaate	कमाते	कमाते	pred_true
kamate	कमाते	कमते	pred_false
kamere	कमेरे	कमेरे	pred_true
kmere	कमेरे	कमेरे	pred_true
karanj	करंज	करंज	pred_true
kranj	करंज	क्रंज	pred_false
karanjiya	करंजिया	करणजीय	pred_false
kardhe	करघे	कर्धे	pred_false
karghe	करघे	कर्घे	pred_false
karachana	करछना	काचचना	pred_false
karchhana	करछना	कर्चना	pred_false
karna	करना	करना	pred_true
karpatri	करपात्री	कर्पत्री	pred_false
karam	करम	कारम	pred_false
karoor	करूर	करूर	pred_true
karur	करूर	कारूर	pred_false
karnataka	कर्नाटका	कारनाका	pred_false
karvi	कर्वी	कारवी	pred_false
kurvi	कर्वी	कुर्वी	pred_false
kalmein	कलमें	कालमें	pred_false
kalmen	कलमें	कलमें	pred_true
kalraj	कलराज	कलराज	pred_true
kalika	कलिका	कालिका	pred_false
kalpanaon	कल्पनाओं	कल्पनाओं	pred_true
kalpnaon	कल्पनाओं	कल्पनाओं	pred_true
kavvaliyon	कव्वालियों	कववालियों	pred_false
qawwaliyon	कव्वालियों	कवववालियों	pred_false
kavvali	कव्वाली	कववाली	pred_false
qawwali	कव्वाली	कवववाली	pred_false
kashton	कष्टों	काषतों	pred_false
kasarat	कसरत	कसरत	pred_true
kasrat	कसरत	कसरत	pred_true
kasara	कसारा	कसरा	pred_false
kasida	कसीदा	कसीदा	pred_true
kahane	कहने	कहाने	pred_false
kahne	कहने	कहने	pred_true
kahlaya	कहलाया	कहलाया	pred_true
kahaniyon	कहानियों	कहानियों	pred_true
kile	क़िले	किले	pred_false
kanji	कांजी	कांजी	pred_true
cant	कांट	केंट	pred_false
kant	कांट	कंत	pred_false
kanti	कांति	कांती	pred_false
kakoo	काकू	काकू	pred_true
kaku	काकू	काकू	pred_true
kaagaj	कागज़	काग़ज़	pred_false
kaagaz	कागज़	काग़ज़	pred_false
kagaj	कागज़	कागज	pred_false
kagaz	कागज़	काग़	pred_false
kaaji	काजी	काजी	pred_true
kaji	काजी	काजी	pred_true
kazi	काजी	काजी	pred_true
qazi	काजी	काजी	pred_true
kajoo	काजू	काजू	pred_true
kaju	काजू	काजू	pred_true
kapadi	कापड़ी	कपड़ी	pred_false
kapdi	कापड़ी	कपड़ी	pred_false
kamraj	कामराज	कमराज	pred_false
kamottejana	कामोत्तेजना	कामतटेजना	pred_false
kamottejna	कामोत्तेजना	कामतटेना	pred_false
kailana	कायलाना	कैलना	pred_false
kaylana	कायलाना	कालाना	pred_false
carfi	कार्की	कार्फी	pred_false
karki	कार्की	कार्की	pred_true
kartik	कार्तिक	कार्तिक	pred_true
karyakartaon	कार्यकर्ताओं	कार्यकर्ताओं	pred_true
karykartaaon	कार्यकर्ताओं	कार्यकर्ताओं	pred_true
karykartaon	कार्यकर्ताओं	कार्यकर्ताओं	pred_true
karyabhar	कार्यभार	कार्यभार	pred_true
karybhar	कार्यभार	कार्यभार	pred_true
karyarat	कार्यरत	कार्यारत	pred_false
karyrat	कार्यरत	कार्यात	pred_false
kaalpi	कालपी	काल्पी	pred_false
kalapi	कालपी	कलापी	pred_false
kalpi	कालपी	कल्पी	pred_false
kalika	कालिका	कालिका	pred_true
kalighat	कालीघाट	कलीघाट	pred_false
coldvel	काल्डवेल	कॉल्डवेल	pred_false
kaldvel	काल्डवेल	कलददवेल	pred_false
kaldwell	काल्डवेल	कालदेल	pred_false
kaav	काव	काव	pred_true
kav	काव	काव	pred_true
kaasht	काश्त	काष्ट	pred_false
kasht	काश्त	काष्ट	pred_false
kasim	कासिम	कसीम	pred_false
qasim	कासिम	कसीम	pred_false
kasimabad	कासिमाबाद	कसीमाबाद	pred_false
kiya	किया	किया	pred_true
kiliyan	किलियन	किलियां	pred_false
killat	किल्लत	किल्लत	pred_true
killi	किल्ली	किल्ली	pred_true
kisaani	किसानी	किसानी	pred_true
kisani	किसानी	किसनी	pred_false
kisanon	किसानों	किसनों	pred_false
keede	कीड़े	कीड़े	pred_true
kide	कीड़े	कीदे	pred_false
keynote	कीनोट	कैनोट	pred_false
kinote	कीनोट	किनोट	pred_false
kiratpur	कीरतपुर	किरतपुर	pred_false
kundal	कुंडल	कुंदल	pred_false
kundaliya	कुंडलियाँ	कुंडलिया	pred_false
kundaliyan	कुंडलियाँ	कुंदलियां	pred_false
kutta	कुत्ता	कुट्टा	pred_false
kuposhit	कुपोषित	कुपोषित	pred_true
kumau	कुमाऊ	कुमौ	pred_false
kumavat	कुमावत	कुमावट	pred_false
kumawat	कुमावत	कुमावत	pred_true
kural	कुराल	कुरल	pred_false
kurmi	कुर्मी	कुर्मी	pred_true
kursiyon	कुर्सियों	कुरसियों	pred_false
kush	कुश	कुश	pred_true
kushaan	कुषाण	कुशान	pred_false
kushan	कुषाण	कुशान	pred_false
kusumalataa	कुसुमलता	कुसुलाता	pred_false
kusumalta	कुसुमलता	कुसुलात	pred_false
kusumlata	कुसुमलता	कुसुलता	pred_false
koot	कूट	कूट	pred_true
kut	कूट	कुट	pred_false
kritika	कृतिका	कृतिका	pred_true
kpo	केपीओ	कपपो	pred_false
canterbari	कैंटरबरी	कंंटरबारी	pred_false
canterbury	कैंटरबरी	कैंटरी	pred_false
candidate	कैंडिडेट	कंंदीडते	pred_false
katrina	कैटरीना	कतृणा	pred_false
caitlyn	कैटलिन	कैटल्न	pred_false
cateline	कैटलिन	कैटलाइन	pred_false
catlin	कैटलिन	कैटलिन	pred_true
cadmium	कैडमियम	कैडमियम	pred_true
catholic	कैथोलिक	कैथलिक	pred_false
catholicon	कैथोलिकों	कैथलिकों	pred_false
kaetholikon	कैथोलिकों	कैथोलिकों	pred_true
capacitor	कैपेसिटर	कैपेटिटर	pred_false
carat	कैरेट	कारेट	pred_false
cavity	कैविटी	केविटी	pred_false
cavalry	कैवेलरी	कावलेरी	pred_false
kaivelari	कैवेलरी	कैवेलारी	pred_false
complex	कॉम्प्लेक्स	कंप्ल्क्स	pred_false
kocchi	कोच्चि	कोचछी	pred_false
kochi	कोच्चि	कोची	pred_false
corridor	कोरिडोर	कॉरिडोर	pred_false
corolla	कोरोला	कोरोला	pred_true
korola	कोरोला	कोरोला	pred_true
caolan	कोलन	कालन	pred_false
colan	कोलन	कोलन	pred_true
colon	कोलन	कोलों	pred_false
calling	कोलिंग	केलिंग	pred_false
koling	कोलिंग	कोलिंग	pred_true
colorado	कोलोराडो	कलोरेडो	pred_false
kolorado	कोलोराडो	कोलोड़ो	pred_false
kaushal	कौशल	कौशाल	pred_false
kaushalata	कौशलता	कौशलता	pred_true
kaushalta	कौशलता	कौशलता	pred_true
kaushambi	कौशाम्बी	कौशंबी	pred_false
cute	क्यूट	कट	pred_false
quete	क्यूट	क्वेट	pred_false
cube	क्यूब	कब्यूब	pred_false
cubeck	क्यूबेक	कबल्क	pred_false
quebec	क्यूबेक	क्वेबेक	pred_false
cubes	क्यूब्स	कब्स	pred_false
krantiyon	क्रांतियों	क्रातियों	pred_false
cric	क्रिक	क्रिक	pred_true
crick	क्रिक	क्रिक	pred_true
cricket	क्रिकेट	क्रिकट	pred_false
cricketer	क्रिकेटर	क्रिकटर	pred_false
cricketing	क्रिकेटिंग	क्रिकटिंग	pred_false
kriyayog	क्रियायोग	क्रियायोग	pred_true
christian	क्रिश्चयन	क्रिस्टियन	pred_false
kruger	क्रूगर	क्रेजर	pred_false
craig	क्रेग	क्रेइग	pred_false
creg	क्रेग	क्रेज	pred_false
cradle	क्रैडल	क्रेडल	pred_false
chrom	क्रोम	च्रोम	pred_false
chrome	क्रोम	च्रोम	pred_false
client	क्लांइट	क्लाइंट	pred_false
clock	क्लाक	क्लॉक	pred_false
clasen	क्लासें	क्लासन	pred_false
classen	क्लासें	क्लासेन	pred_false
classon	क्लासों	क्लासों	pred_true
clay	क्ले	क्ले	pred_true
claris	क्लेरिस	क्लारिस	pred_false
cleris	क्लेरिस	क्लररिस	pred_false
clerys	क्लेरिस	क्लर्स	pred_false
quantico	क्वांटिको	क्वांटिको	pred_true
queens	क्वींस	क्वींस	pred_true
kshitij	क्षितिज	क्षितीज	pred_false
shitij	क्षितिज	शितिज	pred_false
kshin	क्षीण	क्षिण	pred_false
shin	क्षीण	शिन	pred_false
kshetron	क्षेत्रों	क्षेत्रों	pred_true
shetron	क्षेत्रों	श्षेट्रों	pred_false
khand	खंडा	खंंड	pred_false
khanda	खंडा	खांडा	pred_false
khachakhach	खचाखच	खचाखच	pred_true
khajarana	खजराना	खजराना	pred_true
khajraana	खजराना	खजराना	pred_true
khajrana	खजराना	खजराना	pred_true
khatakati	खटकती	खटकती	pred_true
khatakti	खटकती	खटकती	pred_true
kihatkati	खटकती	किहत्ति	pred_false
khattapan	खट्टापन	खट्टापन	pred_true
khat	खत	खात	pred_false
khani	खनि	खानी	pred_false
khanik	खनिक	खािक	pred_false
khanikarm	खनिकर्म	खानिकर्म	pred_false
khanikarma	खनिकर्म	खानिकर्म	pred_false
khanikarmi	खनिकर्म	खानिकर्मी	pred_false
khapat	खपत	खपट	pred_false
khariya	खरिया	खरिया	pred_true
khalnayak	खलनायक	खलनायक	pred_true
khaaskar	ख़ासकर	खासकर	pred_false
khaskar	ख़ासकर	खासकर	pred_false
khaastaur	ख़ासतौर	खासतौर	pred_false
khastaur	ख़ासतौर	खस्तौर	pred_false
khaibar	ख़ैबर	खैबर	pred_false
khyber	ख़ैबर	खाबर	pred_false
khaein	खाएं	खाइं	pred_false
khaen	खाएं	खाएं	pred_true
khayen	खाएं	खाएं	pred_true
khaate	खाते	खाते	pred_true
khaatey	खाते	खाते	pred_true
khate	खाते	खाते	pred_true
khal	खाल	खलल	pred_false
khinchakar	खिंचकर	खिंचका	pred_false
khinchkar	खिंचकर	खिंचकर	pred_true
khilana	खिलाना	खिलना	pred_false
khinchkar	खींचकर	खिंचकर	pred_false
khuda	खुदा	खुदा	pred_true
khudai	खुदाई	खुदाई	pred_true
khurapka	खुरपका	खुरापका	pred_false
khurpaka	खुरपका	खुर्पका	pred_false
khurasan	खुरासान	खुरसन	pred_false
khushiyan	खुशियां	खुशियां	pred_true
khene	खेने	खेने	pred_true
khaini	खैनी	खैनी	pred_true
khairati	खैराती	खैरती	pred_false
khoikhoi	खोईखोई	खोईखोई	pred_true
khoya	खोया	खोया	pred_true
gangrel	गंगरेल	गंग्रेल	pred_false
gangaajal	गंगाजल	गंगाजल	pred_true
gangajal	गंगाजल	गंगजाल	pred_false
gandaki	गंडकी	गंडकी	pred_true
gandki	गंडकी	गंडकी	pred_true
gandh	गंध	गंध	pred_true
gandha	गंध	गंधा	pred_false
gae	गए	गाई	pred_false
gaye	गए	गाये	pred_false
gajara	गजरा	गजरा	pred_true
gajra	गजरा	गजरा	pred_true
gadkar	गडकर	गड़कर	pred_false
ganapati	गणपति	गणपती	pred_false
ganpati	गणपति	गणपती	pred_false
gatisheel	गतिशील	गतिशील	pred_true
gatishil	गतिशील	गतिशील	pred_true
gatishilata	गतिशीलता	गतिशीलता	pred_true
gadadhar	गदाधर	गादधार	pred_false
gammat	गम्मत	गम्मत	pred_true
gaya	गया	गाया	pred_false
garibi	गरीबी	गरीबी	pred_true
garjana	गर्जना	गर्जना	pred_true
galgand	गलगंड	गैगगंड	pred_false
gahmagahmi	गहमागहमी	गहमगाहमी	pred_false
gemhagehmi	गहमागहमी	गेमहगेमी	pred_false
ganguly	गांगुली	गंगुली	pred_false
gaanth	गांठ	गांठ	pred_true
ganth	गांठ	गंथ	pred_false
gaanthe	गांठे	गांठे	pred_true
ganthe	गांठे	गंथे	pred_false
ganthen	गांठें	गंथें	pred_false
ganthon	गांठों	गंथों	pred_false
gaen	गाएं	गाएं	pred_true
gayen	गाएं	गाएं	pred_true
gazi	गाज़ी	गाजी	pred_false
gajipur	गाजीपुर	गजीीपुर	pred_false
gazipur	गाजीपुर	गाजीपुर	pred_true
gayatri	गायत्री	गायत्री	pred_true
gayitri	गायत्री	गायित्री	pred_false
gaytri	गायत्री	गायत्री	pred_true
gidgidate	गिड़गिड़ाते	गिदगिडतत	pred_false
ginate	गिनते	गिनाते	pred_false
ginte	गिनते	गिंट	pred_false
girkar	गिरकर	गिरकार	pred_false
girijaghar	गिरजाघर	गिरिजाघर	pred_false
girjaghar	गिरजाघर	गिरजाघर	pred_true
girijagharon	गिरजाघरों	गिरिजाघों	pred_false
girjagharon	गिरजाघरों	गिरजाघरों	pred_true
girati	गिरती	गिराती	pred_false
girti	गिरती	गिरती	pred_true
girish	गिरीश	गिरीश	pred_true
guan	गुआन	गुआन	pred_true
gujar	गुजार	गुजर	pred_false
gujarata	गुजारता	गुजरता	pred_false
gujarta	गुजारता	गुजरता	pred_false
gujarate	गुजारते	गुजराते	pred_false
gujarte	गुजारते	गुजरते	pred_false
gujarana	गुजारना	गुजराना	pred_false
gujarna	गुजारना	गुजर्ण	pred_false
gujara	गुजारा	गुजरा	pred_false
gujare	गुजारे	गुजरे	pred_false
gutta	गुट्टा	गुट्टा	pred_true
gthalidar	गुठलीदार	गठालीदार	pred_false
guthalidar	गुठलीदार	गुतलीदार	pred_false
gudna	गुदना	गुड़ना	pred_false
gumaan	गुमान	गुमान	pred_true
guman	गुमान	गुमान	pred_true
gulshan	गुलशन	गुलशान	pred_false
gunga	गूंगा	गुंगा	pred_false
grihnagar	गृहनगर	गृहनागर	pred_false
gruhnagar	गृहनगर	गृहणागर	pred_false
galaxion	गैलेक्सियों	गैल्कियन	pred_false
galaxiyon	गैलेक्सियों	गलाकियों	pred_false
galaxyon	गैलेक्सियों	गलाक्सियों	pred_false
gochar	गोचर	गोचार	pred_false
gouchar	गोचर	गौचार	pred_false
godara	गोदारा	गोदारा	pred_true
gopichand	गोपीचंद	गोपीचंद	pred_true
gomake	गोमके	गोमक	pred_false
gomke	गोमके	गोमके	pred_true
goel	गोयल	गोल	pred_false
goyal	गोयल	गोयल	pred_true
gosvaami	गोस्वामी	गोस्वामी	pred_true
gosvami	गोस्वामी	गोस्वामी	pred_true
goswami	गोस्वामी	गोस्वामी	pred_true
gaumukh	गौमुख	गौमुख	pred_true
gomukh	गौमुख	गोमुख	pred_false
gaumutr	गौमूत्र	गौमुत्र	pred_false
gaumutra	गौमूत्र	गौमुत्र	pred_false
gowmutra	गौमूत्र	गुमुत्र	pred_false
granthiyaan	ग्रंथियां	ग्रांठियां	pred_false
granthiyan	ग्रंथियां	ग्रांठियां	pred_false
grandhiyon	ग्रंथियों	ग्रांधियों	pred_false
granthiyon	ग्रंथियों	ग्रांठियों	pred_false
greest	ग्रीस्ट	ग्रीस्ट	pred_true
greist	ग्रीस्ट	ग्रीस्ट	pred_true
grist	ग्रीस्ट	ग्रिस्ट	pred_false
greg	ग्रेग	ग्रेग	pred_true
granite	ग्रेनाइट	ग्रानीट	pred_false
grenite	ग्रेनाइट	ग्रेनीट	pred_false
grandson	ग्रैंडसन	ग्रैंडसन	pred_true
gross	ग्रॉस	ग्रोस	pred_false
ghataatop	घटाटोप	घटातोप	pred_false
ghatatop	घटाटोप	घटटोप	pred_false
ghataayaa	घटाया	घटाया	pred_true
ghataya	घटाया	घटाया	pred_true
ghanakar	घनाकार	घनाकर	pred_false
ghabrahat	घबराहट	घब्रहहत	pred_false
ghasi	घासी	घसी	pred_false
ghisai	घिसाई	घिसाई	pred_true
ghisi	घिसी	घिसी	pred_true
ghise	घिसे	घिसे	pred_true
ghumakkadi	घुमक्कड़ी	घुमक्कड़ी	pred_true
ghumakkdi	घुमक्कड़ी	घुमक्कड़ी	pred_true
ghumakkadon	घुमक्कड़ों	घुमक्कड़ों	pred_true
ghumakkaron	घुमक्कड़ों	घुमक्करों	pred_false
ghumakkdon	घुमक्कड़ों	घुमक्डों	pred_false
ghummakkadon	घुमक्कड़ों	घुम्मकदों	pred_false
ghumaan	घुमाण	घुमान	pred_false
ghuman	घुमाण	घुमान	pred_false
ghoonsa	घूंसा	घूंसा	pred_true
ghunsa	घूंसा	घुंसा	pred_false
ghongha	घोंघा	घोंघा	pred_true
ghontane	घोंटने	घोंटने	pred_true
ghontne	घोंटने	घोंटने	pred_true
ghot	घोट	घोट	pred_true
ghodi	घोड़ी	घोड़ी	pred_true
ghost	घोस्ट	घोस्ट	pred_true
changul	चंगुल	चंगुल	pred_true
chand	चंद	चांद	pred_false
chandan	चंदन	चंदन	pred_true
chandana	चंदन	चंदना	pred_false
chandu	चंदू	चंदू	pred_true
chandon	चंदों	चंदों	pred_true
chandrabali	चंद्रबली	चंद्रबली	pred_true
chandramaon	चंद्रमाओं	चंद्रमाओं	pred_true
chakatte	चकत्ते	चकत्टे	pred_false
chaktte	चकत्ते	चकतते	pred_false
chakkar	चक्कर	चक्कर	pred_true
chkkar	चक्कर	चक्कर	pred_true
chakshu	चक्षु	चक्ष्शु	pred_false
chatagaon	चटगांव	चटागावंं	pred_false
chatgaon	चटगांव	चटगांव	pred_true
chadhane	चढ़ने	चढ़ाने	pred_false
chadhne	चढ़ने	चढ़ने	pred_true
chaturdik	चतुर्दिक	चतुर्दिक	pred_true
chatunshkoniy	चतुष्कोणीय	चतुनशक्षोन	pred_false
chatushkoniy	चतुष्कोणीय	चतुतशकों	pred_false
chatushkoniya	चतुष्कोणीय	चतुशिक्षोय	pred_false
channa	चन्ना	चाना	pred_false
chabate	चबाते	चबाते	pred_true
chabutare	चबूतरे	चबबूतरे	pred_false
chabutre	चबूतरे	चबबुत्रे	pred_false
chamakna	चमकना	चमकना	pred_true
chamkana	चमकना	चमकाना	pred_false
charas	चरस	चारस	pred_false
charit	चरित	चारित	pred_false
charcha	चर्चा	चर्चा	pred_true
churcha	चर्चा	चर्चा	pred_true
charchaon	चर्चाओं	चर्चाओं	pred_true
chalenge	चलेंगे	चलेंगे	pred_true
chlenge	चलेंगे	च्लेंग	pred_false
chahunaur	चहुंओर	चाहूनुर	pred_false
chahunor	चहुंओर	चाहूनोर	pred_false
chanval	चांवल	चनवाल	pred_false
chanwal	चांवल	चनवाल	pred_false
chachaji	चाचाजी	चछाजी	pred_false
chadar	चादर	चादर	pred_true
chadaron	चादरों	चड़ारों	pred_false
chadron	चादरों	चड्डों	pred_false
chan	चान	चान	pred_true
chanan	चानन	चनन	pred_false
chaplusi	चापलूसी	चपलुसी	pred_false
chayal	चायल	चयाल	pred_false
char	चार	चार	pred_true
charon	चारों	चारों	pred_true
charge	चार्ज	चार्ज	pred_true
chart	चार्ट	चार्ट	pred_true
charton	चार्टों	चारतों	pred_false
charts	चार्ट्स	चार्ट्स	pred_true
chaalit	चालित	चालित	pred_true
chalit	चालित	चलीत	pred_false
chikitsak	चिकित्सक	चिकित्सक	pred_true
chikitsakon	चिकित्सकों	चिकित्सकों	pred_true
chikhali	चिखली	चिखली	pred_true
chiththi	चिट्ठी	चित्ठी	pred_false
chitthi	चिट्ठी	चित्ठी	pred_false
chithhi	चिठ्ठी	चिथही	pred_false
chiththi	चिठ्ठी	चित्ठी	pred_false
chitthi	चिठ्ठी	चित्ठी	pred_false
chidchidapan	चिडचिडापन	चिड़चिड़पान	pred_false
chidchidapan	चिड़चिड़ापन	चिड़चिड़पान	pred_false
chidhate	चिढ़ते	चिद्धते	pred_false
chidhte	चिढ़ते	चिद्धते	pred_false
chithrkar	चित्रकार	चित्रकर	pred_false
chitrkar	चित्रकार	चित्रकार	pred_true
chipakane	चिपकने	चिपकने	pred_true
chipakne	चिपकने	चिपकने	pred_true
chipkane	चिपकने	चिपकाने	pred_false
chimati	चिमटी	चिमटी	pred_true
chimti	चिमटी	चिमटी	pred_true
chillane	चिल्लाने	चिल्लने	pred_false
chee	ची	ची	pred_true
chi	ची	ची	pred_true
chuka	चुका	चुका	pred_true
chune	चुने	चुने	pred_true
chunar	चूनर	चुनार	pred_false
changed	चेंज्ड	चागेंड	pred_false
chetti	चेट्टी	चेत्ती	pred_false
chennai	चेन्नई	चेनाई	pred_false
chero	चेरो	चेरो	pred_true
chest	चेस्ट	चेस्ट	pred_true
championship	चैंपियनशिप	चंपियंशिप	pred_false
chor	चोर	चोर	pred_true
choro	चोरों	चोरो	pred_false
choron	चोरों	चोरों	pred_true
chauk	चौक	चौक	pred_true
chowk	चौक	चौक	pred_true
chauka	चौका	चौका	pred_true
chuka	चौका	चुका	pred_false
chaukiyan	चौकियां	चौकियां	pred_true
chauki	चौकी	चौकी	pred_true
chaukhate	चौखटे	चौखते	pred_false
chauguni	चौगुनी	चौगुनी	pred_true
chauda	चौड़ा	चौड़ा	pred_true
chaudah	चौड़ा	चौदह	pred_false
chaudahavan	चौदहवां	चौदहावन	pred_false
chaudhavan	चौदहवां	चौधवान	pred_false
chaudhawan	चौदहवां	चौढवान	pred_false
chaupati	चौपाटी	चौपती	pred_false
chupaty	चौपाटी	चुपाटी	pred_false
chaupal	चौपाल	चौपाल	pred_true
chaurai	चौरई	चौरई	pred_true
chausinga	चौसिंगा	चौसिंगा	pred_true
chausingha	चौसिंगा	चौसिंह	pred_false
chhagan	छगन	छगान	pred_false
chhabi	छबि	छाबी	pred_false
chhalla	छल्ला	छल्ला	pred_true
chhallaa	छल्ला	छल्ला	pred_true
chhaviyaan	छवियाँ	छवियां	pred_false
chhaviyan	छवियाँ	छावियां	pred_false
chhavi	छवी	छावी	pred_false
cheh	छह	चेह	pred_false
chhah	छह	छाह	pred_false
chehon	छहों	चेहों	pred_false
chhahon	छहों	छाहों	pred_false
chhai	छाई	छाई	pred_true
chhagla	छागला	छगला	pred_false
chhajan	छाजन	छजन	pred_false
chhaati	छाती	छाती	pred_true
chhati	छाती	छती	pred_false
chhaapemaar	छापेमार	छापेमार	pred_true
chhapemar	छापेमार	छापेमर	pred_false
chheenk	छींक	छिंक	pred_false
chhink	छींक	छिंक	pred_false
chink	छींक	चिंक	pred_false
chenkein	छींके	चेंकें	pred_false
chhekein	छींके	छेकें	pred_false
chhinke	छींके	छिंके	pred_false
chhinky	छींके	छिंकी	pred_false
chinke	छींके	चिंके	pred_false
chhudaane	छुडाने	छुड़ाने	pred_false
chhudane	छुडाने	छुड़ाने	pred_false
chhupakar	छुपकर	छुपका	pred_false
chhupkar	छुपकर	छुपककार	pred_false
chhupkr	छुपकर	छुपक्कर	pred_false
chhupata	छुपता	छुपाता	pred_false
chhupta	छुपता	छुप्टा	pred_false
chhuptaa	छुपता	छुप्टा	pred_false
chhura	छुरा	छुरा	pred_true
chhuraa	छुरा	छुरा	pred_true
chhuree	छुरी	छुरी	pred_true
chhuri	छुरी	छुरी	pred_true
chhure	छुरे	छुरे	pred_true
chhootane	छूटने	छूटने	pred_true
chhutane	छूटने	छुटने	pred_false
chhutne	छूटने	छुटने	pred_false
chheter	छेत्र	छेतर	pred_false
chhetr	छेत्र	छेत्र	pred_true
chhetter	छेत्र	छेटर	pred_false
chhetri	छेत्री	छेत्री	pred_true
chhetthari	छेत्री	छेत्थरी	pred_false
chhetthri	छेत्री	छेत्थरी	pred_false
chai	छै	चाई	pred_false
chhai	छै	छाई	pred_false
chhe	छै	छे	pred_false
jagaega	जगाएगा	जगागगा	pred_false
jagayega	जगाएगा	जगाएगा	pred_true
jaghaega	जगाएगा	जगाएगा	pred_true
jgaayega	जगाएगा	जगाएगा	pred_true
jgayegaa	जगाएगा	जगाएगा	pred_true
jajaon	जजों	जजाओं	pred_false
jajon	जजों	जाजों	pred_false
jad	जड़	जाड़	pred_false
jadd	जड़	जाद	pred_false
jaddit	जड़ित	जद्दित	pred_false
jadeite	जड़ित	जादीते	pred_false
jadet	जड़ित	जड़ेत	pred_false
jadit	जड़ित	जादित	pred_false
jadein	जड़ें	जाें	pred_false
jaden	जड़ें	जादें	pred_false
jatara	जतरा	जतारा	pred_false
jatra	जतरा	जात्र	pred_false
jataati	जताती	जताती	pred_true
jatatee	जताती	जताती	pred_true
jatati	जताती	जतती	pred_false
janagananaa	जनगणना	जनगनना	pred_false
janaganna	जनगणना	जनगन्ना	pred_false
jangadnaa	जनगणना	जंगदना	pred_false
janganana	जनगणना	जंगनना	pred_false
janganna	जनगणना	जंगनना	pred_false
janajagran	जनजागरण	जनजागरण	pred_true
janjaagran	जनजागरण	जनजागरण	pred_true
janjagran	जनजागरण	जनजागरण	pred_true
january	जनवरी	जननीरी	pred_false
janahaani	जनहानि	जनहानी	pred_false
janahani	जनहानि	जनहानी	pred_false
janhaani	जनहानि	जनहानी	pred_false
janhani	जनहानि	जनहानी	pred_false
jnhaani	जनहानि	जनहानी	pred_false
jamaate	जमाती	जमाते	pred_false
jamaati	जमाती	जमाती	pred_true
jamati	जमाती	जमती	pred_false
jamaaya	जमाया	जमाया	pred_true
jamaeya	जमाया	जमाया	pred_true
jamaya	जमाया	जमाया	pred_true
jamayaa	जमाया	जमाया	pred_true
jamuai	जमुई	जमुई	pred_true
jamuei	जमुई	जमुई	pred_true
jamui	जमुई	जमूई	pred_false
jai	जय	जई	pred_false
jay	जय	जा	pred_false
jaidayal	जयदयाल	जयदयल	pred_false
jayadayal	जयदयाल	जयदयाल	pred_true
jaydayal	जयदयाल	जयदयल	pred_false
jaibaan	जयबाण	जयबान	pred_false
jaiban	जयबाण	जाबान	pred_false
jaybaan	जयबाण	जयबान	pred_false
jayalalita	जयललिता	जयललिता	pred_true
jayalalitaa	जयललिता	जयललिता	pred_true
jayalalithaa	जयललिता	जयललिथा	pred_false
jaylalita	जयललिता	जयललिता	pred_true
jarakh	जरख	जरख	pred_true
zarakh	जरख	जरख	pred_true
jarda	जर्दा	जर्दा	pred_true
jardaa	जर्दा	जरदा	pred_false
zarda	जर्दा	ज़र्दा	pred_false
jalagati	जलगति	जलगति	pred_true
jalgati	जलगति	जलगती	pred_false
jalgti	जलगति	जलगती	pred_false
jalte	जलते	जलते	pred_true
jalbharav	जलभराव	जलभररव	pred_false
jalbhraav	जलभराव	जलभराव	pred_true
jalbhrav	जलभराव	जलभर्व	pred_false
jalvaayu	जलवायु	जलवायु	pred_true
jalvayu	जलवायु	जलवायु	pred_true
jalesar	जलेसर	जलल्सर	pred_false
jasmeet	जसमीत	जसमीत	pred_true
jasmit	जसमीत	जसमीत	pred_true
jassee	जस्सी	जससी	pred_false
jassi	जस्सी	जससी	pred_false
jamaanaa	ज़माना	जमाना	pred_false
jamana	ज़माना	जमाना	pred_false
zamaanaa	ज़माना	जमाना	pred_false
zamana	ज़माना	जमाना	pred_false
jaljale	ज़लज़ले	जलजाले	pred_false
zalzale	ज़लज़ले	जलजाले	pred_false
zee	ज़ी	जी	pred_false
jubaan	ज़ुबान	जुबान	pred_false
juban	ज़ुबान	जुबान	pred_false
zuban	ज़ुबान	जुबान	pred_false
jaanch	जाँच	जांच	pred_false
jaaunch	जाँच	जाऊंच	pred_false
janch	जाँच	जांच	pred_false
jaunch	जाँच	जौंच	pred_false
jaagriti	जागृति	जागृति	pred_true
jagriti	जागृति	जगरीति	pred_false
jagruti	जागृति	जगरृति	pred_false
jajamau	जाजमऊ	जजमाऊ	pred_false
jajmau	जाजमऊ	जजमा	pred_false
jajmauu	जाजमऊ	जजमौऊ	pred_false
jaat	जात	जात	pred_true
jat	जात	जा	pred_false
jaatak	जातक	जातक	pred_true
jatak	जातक	जटक	pred_false
jaatakon	जातकों	जाटकों	pred_false
jaatkon	जातकों	जाटकों	pred_false
jatakon	जातकों	जटकों	pred_false
jaatiyon	जातियों	जातियों	pred_true
jatiyon	जातियों	जटियों	pred_false
jaankaaron	जानकारों	जानकरों	pred_false
jaankaron	जानकारों	जानकरों	pred_false
jankaron	जानकारों	जाकारों	pred_false
jaanam	जानम	जान्म	pred_false
janam	जानम	जन्म	pred_false
jaayke	जायके	जायक	pred_false
jayke	जायके	जायक	pred_false
jaawar	जावर	जावर	pred_true
zawar	जावर	जवार	pred_false
jing	जिंग	जिंग	pred_true
gin	जिन	गिन	pred_false
jeen	जिन	जीन	pred_false
jin	जिन	जिन	pred_true
ginee	जिनी	गिनी	pred_false
jinee	जिनी	जिनी	pred_true
jini	जिनी	जीनी	pred_false
geneva	जिनीवा	जेनेवा	pred_false
jeneva	जिनीवा	जेनेवा	pred_false
jiniva	जिनीवा	जिनिवा	pred_false
gypsy	जिप्सी	जिप्सी	pred_true
jimme	जिम्मे	जिम्मे	pred_true
jiya	जिया	जीया	pred_false
gic	जीआईसी	जीसी	pred_false
gr	जीआर	ग्र	pred_false
gm	जीएम	जीएम	pred_true
gsm	जीएसएम	एगसीएम	pred_false
gtod	जीतोड़	गटोड	pred_false
gtor	जीतोड़	गिटोर	pred_false
jeetod	जीतोड़	जीतोड़	pred_true
jitod	जीतोड़	जितोड़	pred_false
jean	जीन	जिन	pred_false
jeen	जीन	जीन	pred_true
jin	जीन	जिन	pred_false
jeenon	जीनों	जीनों	pred_true
jinon	जीनों	जीनों	pred_true
jeepney	जीपनी	जीपने	pred_false
jipani	जीपनी	जिपनी	pred_false
jeeyo	जीयो	जीयो	pred_true
jio	जीयो	जिओ	pred_false
jiyo	जीयो	जियो	pred_false
jeera	जीरा	जीरा	pred_true
jira	जीरा	जीरा	pred_true
jeevant	जीवंत	जीवंत	pred_true
jivant	जीवंत	जीवंत	pred_true
jeevan	जीवन	जीवन	pred_true
jeewan	जीवन	जीवान	pred_false
jivan	जीवन	जीवन	pred_true
jiwan	जीवन	जीवन	pred_true
jeevanshaili	जीवनशैली	जीवनशीली	pred_false
jivanshaili	जीवनशैली	जीवनशीली	pred_false
jeevniyaan	जीवनियां	जीवनियां	pred_true
jivaniya	जीवनियां	जीवनिया	pred_false
jivaniyaan	जीवनियां	जीवनियां	pred_true
jivaniyan	जीवनियां	जीवनियां	pred_true
jeevraaj	जीवराज	जीवराज	pred_true
jivraj	जीवराज	जीवराज	pred_true
jua	जुए	जुआ	pred_false
jue	जुए	जू	pred_false
juye	जुए	जुए	pred_true
jutee	जुटी	जूटी	pred_false
juti	जुटी	जूटी	pred_false
judaai	जुड़ाई	जुड़ई	pred_false
judae	जुड़ाई	जुड़ाई	pred_true
judai	जुड़ाई	जुड़ई	pred_false
judaai	जुदाई	जुड़ई	pred_false
judai	जुदाई	जुड़ई	pred_false
junoon	जुनून	जुनून	pred_true
junun	जुनून	जुनुन	pred_false
junooni	जुनूनी	जुनूनी	pred_true
jununi	जुनूनी	जुनुनी	pred_false
jubair	जुबेर	जुबैर	pred_false
juber	जुबेर	ज़ुबेर	pred_false
zubair	जुबेर	जुबैर	pred_false
juraab	जुराब	जुराब	pred_true
jurab	जुराब	जुराब	pred_true
julaahon	जुलाहों	जुलाहों	pred_true
julahon	जुलाहों	जुलहों	pred_false
julmon	जुल्मों	जुलमों	pred_false
zulmon	जुल्मों	जुलमों	pred_false
jood	जूड	जूड	pred_true
jud	जूड	जुड़	pred_false
junagadh	जूनागढ	जुनागढ़	pred_false
junagarh	जूनागढ	जुनागढ़	pred_false
junior	जूनियर	जुनियर	pred_false
jealous	जूलूस	जीलोस	pred_false
juloos	जूलूस	जुलूस	pred_false
julus	जूलूस	जुलूस	pred_false
jetha	जेठा	जेथा	pred_false
jenner	जेनर	जेनर	pred_true
generic	जेनरिक	जेनरिक	pred_true
jenrick	जेनरिक	ज्रॉिक	pred_false
generat	जेनरेट	जनरेट	pred_false
generate	जेनरेट	जनरेट	pred_false
jenee	जेनी	जेनी	pred_true
jenni	जेनी	जेनी	pred_true
jenny	जेनी	जेनी	pred_true
james	जेम्स	जमम्स	pred_false
jeremy	जेरेमी	जेरीमी	pred_false
gerome	जेरोम	जररोम	pred_false
jerome	जेरोम	जेरोम	pred_true
jacks	जैक्स	जैक्स	pred_true
jain	जैन	जेन	pred_false
gene	जैने	गीने	pred_false
jaine	जैने	जैने	pred_true
jaino	जैनों	जैनो	pred_false
jainon	जैनों	जानों	pred_false
jerry	जैरी	जेरी	pred_false
jasper	जैस्पर	जस्पर	pred_false
jogging	जॉगिंग	जोगिंग	pred_false
johnson	जॉनसन	जॉनससन	pred_false
jobs	जॉब्स	जॉब्स	pred_true
jockey	जोकि	जॉकी	pred_false
joki	जोकि	जोकी	pred_false
jokhim	जोखिम	जोखीम	pred_false
joddta	जोड़ता	जोड़ता	pred_true
jodta	जोड़ता	जोड़ता	pred_true
jorhta	जोड़ता	जोर्तता	pred_false
jodiyon	जोड़ियों	जोड़ियों	pred_true
jodo	जोड़ो	जोडो	pred_false
jaun	जौं	जौन	pred_false
gyatavya	ज्ञातव्य	ज्ञातव्य	pred_true
gyatvy	ज्ञातव्य	ज्ञातव्य	pred_true
gyapit	ज्ञापित	ज्ञापित	pred_true
jyotiba	ज्योतिबा	ज्योतिबा	pred_true
joint	ज्वाइंट	जाइंट	pred_false
jvar	ज्वार	ज्वार	pred_true
jwar	ज्वार	ज्वार	pred_true
jvaaron	ज्वारों	ज्वारों	pred_true
jvaron	ज्वारों	ज्वारों	pred_true
jwaron	ज्वारों	ज्वारों	pred_true
jewellers	ज्वेलर्स	ज्वेलर्स	pred_true
jh	झ	झ	pred_true
jha	झ	झा	pred_false
jhalakti	झलकती	झलकती	pred_true
jhalkati	झलकती	झलकती	pred_true
jhalla	झल्ला	झल्ला	pred_true
jhankana	झांकना	झंकना	pred_false
jhankna	झांकना	झानना	pred_false
jheel	झील	झील	pred_true
jhil	झील	झील	pred_true
jheelon	झीलों	झीलों	pred_true
jhilon	झीलों	झीलों	pred_true
jhuthala	झुठला	झुठला	pred_true
jhuthla	झुठला	झुठला	pred_true
jhuthalane	झुठलाने	झुठलने	pred_false
jhuthlane	झुठलाने	झुठलने	pred_false
tankaar	टंकार	तंकार	pred_false
tankar	टंकार	टंकर	pred_false
takara	टकरा	तकारा	pred_false
takra	टकरा	टार्	pred_false
takaraon	टकरावों	तकााओं	pred_false
takravon	टकरावों	तकरावों	pred_false
tapakti	टपकती	तपकती	pred_false
tapkati	टपकती	तपकती	pred_false
time	टाइम	टाइम	pred_true
timer	टाइमर	टाइमर	pred_true
taoo	टाऊ	टाओ	pred_false
tau	टाऊ	ता	pred_false
tapoowo	टापुओं	तपुवो	pred_false
tapuon	टापुओं	तपुओं	pred_false
tapuwo	टापुओं	तपुवो	pred_false
tied	टायर्ड	टीड	pred_false
tired	टायर्ड	टायर्ड	pred_true
tyred	टायर्ड	टायर्ड	pred_true
tarch	टार्च	टार्च	pred_true
torch	टार्च	टॉर्च	pred_false
tik	टिक	टीक	pred_false
teap	टिप	टीप	pred_false
tip	टिप	टीप	pred_false
tippanikar	टिप्पणीकार	तिप्पानकार	pred_false
tippnikar	टिप्पणीकार	तिप्पनिकार	pred_false
tivolee	टिवोली	तिवोली	pred_false
tivoli	टिवोली	तिवोली	pred_false
teekamgarh	टीकमगढ़	तीकामगढ़	pred_false
tikamgarh	टीकमगढ़	तीकामगढ़	pred_false
teekon	टीकों	टीकों	pred_true
tikon	टीकों	टीकों	pred_true
two	टु	ट्वू	pred_false
tension	टेंशन	टेंशन	pred_true
tenis	टेनिस	टेनिस	pred_true
tennis	टेनिस	टेनिस	pred_true
taste	टेस्ट	तस्ते	pred_false
test	टेस्ट	टेस्ट	pred_true
tasting	टेस्टिंग	टस्टिंग	pred_false
testing	टेस्टिंग	टेस्टिंग	pred_true
tainin	टैनिन	तैनीन	pred_false
tenin	टैनिन	टेनिन	pred_false
tanish	टैनिस	तानीश	pred_false
tennis	टैनिस	टेनिस	pred_false
taboo	टैबू	टाबू	pred_false
taiboo	टैबू	टैबू	pred_true
taobao	टैबू	ताबाओ	pred_false
tonic	टॉनिक	टोनिक	pred_false
tonga	टोंगा	टोंगा	pred_true
toka	टोका	टोका	pred_true
tuesday	ट्यूजडे	टु्सेडे	pred_false
tuning	ट्यूनिंग	टूनिंग	pred_false
tuberculosis	ट्यूबरक्यूलोसिस	टब्र्कललिस	pred_false
tuberkyulosis	ट्यूबरक्यूलोसिस	टब्र्क्युलोसिस	pred_false
truck	ट्रक	ट्रुक	pred_false
trangistor	ट्रांजिस्टर	ट्रांगीस्टर	pred_false
tranjister	ट्रांजिस्टर	ट्रांजीसट	pred_false
transistor	ट्रांजिस्टर	ट्रांसीस्टर	pred_false
transfer	ट्रान्सफर	ट्रांसफर	pred_false
tribunal	ट्रिब्युनल	ट्रिबुयल	pred_false
tribunal	ट्रिब्यूनल	ट्रिबुयल	pred_false
trubyunal	ट्रिब्यूनल	ट्रूब्यनल	pred_false
truth	ट्रुथ	तृथ	pred_false
tuth	ट्रुथ	तथथ	pred_false
traded	ट्रेडेड	ट्रेड्ड	pred_false
trabal	ट्रेबल	ट्रेबल	pred_true
trebal	ट्रेबल	ट्रेबल	pred_true
trouble	ट्रेबल	ट्रबबल	pred_false
traip	ट्रैप	ट्रैप	pred_true
trap	ट्रैप	ट्रेप	pred_false
trot	ट्रॉट	त्रोत	pred_false
trott	ट्रॉट	ट्रॉट	pred_true
thakkar	ठक्कर	थक्कर	pred_false
thakkr	ठक्कर	ठक्कर	pred_true
thaharne	ठहरने	थहरने	pred_false
thahrane	ठहरने	ठहराने	pred_false
theharne	ठहरने	थहरने	pred_false
thikane	ठिकाने	थिकने	pred_false
thumari	ठुमरी	थुमरी	pred_false
thumri	ठुमरी	थूमरी	pred_false
theinga	ठेंगा	ठींगा	pred_false
thenga	ठेंगा	ठेंगा	pred_true
thengaa	ठेंगा	ठेंगा	pred_true
daglas	डगलस	दगलास	pred_false
douglas	डगलस	दुगलास	pred_false
dabhara	डभरा	दाभारा	pred_false
dabhra	डभरा	दभ्र	pred_false
dabhoi	डभोई	दभोई	pred_false
dam	डम	डम	pred_true
dum	डम	डम	pred_true
darate	डराते	डरते	pred_false
daratey	डराते	डरते	pred_false
daravani	डरावनी	दरवानी	pred_false
darawani	डरावनी	दरवानी	pred_false
dravani	डरावनी	द्रवाणी	pred_false
down	डाउन	डाउन	pred_true
daak	डाक	डाक	pred_true
dak	डाक	डक	pred_false
daka	डाका	डका	pred_false
dabi	डाबी	डबी	pred_false
dabolim	डाबोलिम	दबोलिम	pred_false
dinosaur	डायनासोर	दिनोसौर	pred_false
diaries	डायरीज	डायरिस	pred_false
dit	डिट	दीत	pred_false
depthiriya	डिप्थीरिया	दिप्तिरिया	pred_false
diphtheria	डिप्थीरिया	दिफ्थीरिया	pred_false
de	डीई	दे	pred_false
dealership	डीलरशिप	दीलर्शप	pred_false
dvc	डीवीसी	डीवीसी	pred_true
dubaana	डुबाना	दुबाना	pred_false
dubana	डुबाना	दुबाना	pred_false
dubona	डुबोना	दूबोना	pred_false
dulne	डुलने	डुलने	pred_true
doonarpur	डूंगरपुर	दुनारपुर	pred_false
doongarpur	डूंगरपुर	दुंगरपुर	pred_false
dungarpur	डूंगरपुर	दंगारपुर	pred_false
dungerpur	डूंगरपुर	डंगरीपर	pred_false
dubana	डूबना	दुबाना	pred_false
dubna	डूबना	डुबना	pred_false
dangerous	डेंजरस	डांजरूस	pred_false
daisy	डेजी	डैसी	pred_false
dazy	डेजी	देजी	pred_false
deji	डेजी	देजी	pred_false
deputy	डेप्युटी	डिप्टी	pred_false
davidson	डेविडसन	डाविडसन	pred_false
devidson	डेविडसन	डिविडसन	pred_false
davey	डेवी	डवे	pred_false
devi	डेवी	देवी	pred_false
dewey	डेवी	ड्वे	pred_false
destination	डेस्टिनेशन	डिस्टिनेशन	pred_false
datson	डैटसन	दत्सों	pred_false
datsun	डैटसन	दत्सुन	pred_false
daddy	डैडी	डेडी	pred_false
dark	डॉर्क	डर्क	pred_false
dork	डॉर्क	डोर्क	pred_false
dose	डोज	डोस	pred_false
domenic	डोमेनिक	डोमेनिक	pred_true
doranda	डोरंडा	डोरंदा	pred_false
dolane	डोलने	दोलने	pred_false
dolne	डोलने	डोलने	pred_true
dual	ड्युअल	डुएल	pred_false
duak	ड्यूक	डुक	pred_false
duke	ड्यूक	डुके	pred_false
drame	ड्रामे	ड्रेम	pred_false
dramen	ड्रामे	ड्रैमन	pred_false
drager	ड्रेजर	ड्रेजर	pred_true
dredger	ड्रेजर	ड्रेजर	pred_true
dreijer	ड्रेजर	ड्रेजर	pred_true
dhakaal	ढकाल	ढकाल	pred_true
dhakal	ढकाल	ढकाल	pred_true
dhakkal	ढकाल	धक्कल	pred_false
dhkal	ढकाल	ढकाल	pred_true
dhale	ढले	ढाले	pred_false
dhoondh	ढूंढ	धुंध	pred_false
dhundh	ढूंढ	धुंध	pred_false
dhoondhata	ढूंढता	धूंधता	pred_false
dhundhata	ढूंढता	धूंधता	pred_false
dhundhta	ढूंढता	धूंधता	pred_false
dhoondhi	ढूंढी	ढूंधी	pred_false
dhundhi	ढूंढी	ढूंधी	pred_false
tanjavur	तंजावुर	तंजावूर	pred_false
thanjavur	तंजावुर	थंजावुर	pred_false
tantr	तंत्र	तंत्र	pred_true
tantra	तंत्र	तंत्र	pred_true
tantrikao	तंत्रिकाओं	तंत्रिकाओ	pred_false
tantrikaon	तंत्रिकाओं	तंत्रिकाओं	pred_true
tantro	तंत्रों	टंट्रों	pred_false
tantron	तंत्रों	तंत्रों	pred_true
tagade	तगड़े	तगड़े	pred_true
tagde	तगड़े	तगड़े	pred_true
tadipaar	तड़ीपार	तड़ीपार	pred_true
tadipar	तड़ीपार	ताड़पार	pred_false
tani	तनी	तानी	pred_false
tapan	तपन	तपान	pred_false
tarafa	तरफा	तराफा	pred_false
tarfa	तरफा	तारफा	pred_false
tarabganj	तरबगंज	तराबगंज	pred_false
taras	तरस	तारस	pred_false
taraash	तराश	तराश	pred_true
tarash	तराश	तराश	pred_true
tarashay	तराशे	तराशय	pred_false
tarashe	तराशे	तराशे	pred_true
tareeko	तरीको	तरीको	pred_true
tariko	तरीको	तारीको	pred_false
tark	तर्क	टार्क	pred_false
tarkvaad	तर्कवाद	तार्वाद	pred_false
tarkvad	तर्कवाद	तार्वाद	pred_false
tarkwaad	तर्कवाद	तार्वाद	pred_false
tarko	तर्कों	टारको	pred_false
tarkon	तर्कों	टारकों	pred_false
talabgaar	तलबगार	तलाबगार	pred_false
talabgar	तलबगार	तालबगगर	pred_false
talbagaar	तलबगार	तलबबागार	pred_false
talbagar	तलबगार	तालबगार	pred_false
talawe	तलवे	तलावे	pred_false
talve	तलवे	तलवे	pred_true
talawon	तलवों	तालों	pred_false
talvon	तलवों	तालों	pred_false
tahakhana	तहखाना	तहखना	pred_false
tahkhaana	तहखाना	तहखाना	pred_true
tahkhana	तहखाना	तहखना	pred_false
taantaa	तांता	तांता	pred_true
tanta	तांता	तांटा	pred_false
tambe	तांबे	तंबे	pred_false
tanbe	तांबे	तंबे	pred_false
taaja	ताजा	ताजा	pred_true
taajaa	ताजा	ताजा	pred_true
taaza	ताजा	ताजा	pred_true
taja	ताजा	ताजा	pred_true
taza	ताजा	ताजा	pred_true
tansen	तानसेन	तंसें	pred_false
taapmaanon	तापमानों	तापमानों	pred_true
tapmano	तापमानों	तपमानों	pred_false
tapmanon	तापमानों	तपमानों	pred_false
taapti	ताप्ती	ताप्ति	pred_false
tapti	ताप्ती	तप्ति	pred_false
tarabai	ताराबाई	तरबाई	pred_false
taseer	तासीर	तसीर	pred_false
tasir	तासीर	तसीर	pred_false
taahi	ताहि	ताही	pred_false
tahi	ताहि	तहही	pred_false
tikone	तिकोने	टिकोन	pred_false
tirupati	तिरूपति	तिरुपति	pred_false
tiwari	तिवारी	तिवाड़ी	pred_false
ti	ती	ती	pred_true
teer	तीर	टीर	pred_false
tir	तीर	तीर	pred_true
teeron	तीरों	तीरों	pred_true
tiron	तीरों	तीरों	pred_true
tirthatan	तीर्थाटन	तीर्थतन	pred_false
tungnath	तुंगनाथ	तुंगताथ	pred_false
tughlaq	तुगलक	तुघलक	pred_false
tuglak	तुगलक	तुगलाक	pred_false
tughlakabad	तुगलकाबाद	तुगलाकाबाद	pred_false
tughlaqabad	तुगलकाबाद	तुगलाकाबाद	pred_false
tuglakabad	तुगलकाबाद	तुग्लकाबाद	pred_false
tugalaki	तुगलकी	तुगलकी	pred_true
tugalki	तुगलकी	तुगलकी	pred_true
tuglaki	तुगलकी	तुग्लकी	pred_false
tufail	तुफैल	तुफैल	pred_true
tejaji	तेजाजी	तेजाजी	pred_true
teji	तेजी	तेजी	pred_true
tel	तेल	टेल	pred_false
telon	तेलों	टेलों	pred_false
to	तो	टो	pred_false
toh	तो	तो	pred_true
taul	तौल	तौल	pred_true
tyohaar	त्यौहार	त्योहार	pred_false
tyohar	त्यौहार	त्योहार	pred_false
tyoihar	त्यौहार	त्योहार	pred_false
tyauharon	त्यौहारों	त्यौहारों	pred_true
tyoharon	त्यौहारों	त्योहारों	pred_false
tyoiharon	त्यौहारों	त्योहारों	pred_false
trijata	त्रिजटा	त्रिजता	pred_false
trijta	त्रिजटा	त्रित्ता	pred_false
triya	त्रिया	त्रिया	pred_true
tremasik	त्रैमासिक	त्रैमैसिक	pred_false
trimasik	त्रैमासिक	त्रिमासिक	pred_false
tse	त्से	त्से	pred_true
thaki	थकी	थाकी	pred_false
thki	थकी	थकी	pred_true
tharti	थर्टी	थरती	pred_false
thirty	थर्टी	थर्टी	pred_true
thane	थाणे	थान	pred_false
thaanvi	थानवी	थानवी	pred_true
thanvi	थानवी	थानवी	pred_true
theateron	थिएटरों	थीटरों	pred_false
theatron	थिएटरों	थीट्रों	pred_false
theaters	थिएटर्स	थीटर्स	pred_false
theater	थियेटर	थीटर	pred_false
theatre	थियेटर	थीत्रे	pred_false
theateron	थियेटरों	थीटरों	pred_false
theatron	थियेटरों	थीट्रों	pred_false
thitron	थियेटरों	थित्रों	pred_false
theaters	थियेटर्स	थीटर्स	pred_false
theatrs	थियेटर्स	थीट्स	pred_false
thiyeters	थियेटर्स	थियटर्स	pred_false
thirake	थिरके	थिरके	pred_true
thirke	थिरके	थिरके	pred_true
thief	थीफ	थीफ	pred_true
then	थेन	थेन	pred_true
theni	थेनी	थेनी	pred_true
thailee	थैली	थैली	pred_true
thaili	थैली	थैली	pred_true
thaile	थैले	थैले	pred_true
dang	दंग	डंग	pred_false
danga	दंगा	डंगा	pred_false
dangon	दंगों	दंगों	pred_true
dampati	दंपति	दमपपतति	pred_false
danpati	दंपति	दंपति	pred_true
dampatiyon	दंपतियों	दंपातियों	pred_false
dampattiyon	दंपतियों	दंपत्तियों	pred_false
danptiyon	दंपतियों	दंपतियों	pred_true
dadreva	ददरेवा	दादरेवा	pred_false
dadrewa	ददरेवा	दारवा	pred_false
damoh	दमोह	दमोह	pred_true
dardara	दरदरा	दरददारा	pred_false
dardraa	दरदरा	दर्द्रा	pred_false
durdhara	दरदरा	दुर्धरा	pred_false
darmiyaan	दरमियान	दर्मियां	pred_false
darmiyan	दरमियान	डर्मियां	pred_false
darjano	दर्जनों	दर्जनों	pred_true
darjanon	दर्जनों	दर्जनों	pred_true
darp	दर्प	डर्प	pred_false
darra	दर्रा	दररा	pred_false
dalbadal	दलबदल	दलबददल	pred_false
dalbadl	दलबदल	दाबबद्ल	pred_false
dali	दली	दली	pred_true
dastaanaa	दस्ताना	दस्ताना	pred_true
dastana	दस्ताना	दस्ताना	pred_true
dastavej	दस्तावेज	दस्तावेज	pred_true
dahan	दहन	दहन	pred_true
dahal	दहल	दहल	pred_true
da	दा	डीए	pred_false
daakhil	दाखिल	दाख़िल	pred_false
dakhil	दाखिल	दख़िल	pred_false
daakhile	दाखिले	दाखिले	pred_true
dakhile	दाखिले	दखिले	pred_false
daataa	दाता	दाता	pred_true
data	दाता	डाता	pred_false
dadari	दादरी	दादरी	pred_true
daanshil	दानशील	दांशील	pred_false
danshil	दानशील	दनशील	pred_false
daabholkar	दाभोलकर	दाभोलकर	pred_true
dabholkar	दाभोलकर	दाभोलकर	pred_true
damale	दामले	दमले	pred_false
damle	दामले	डामले	pred_false
dayitv	दायित्व	दयित्व	pred_false
dayitva	दायित्व	दायतत्व	pred_false
dayitwa	दायित्व	दयित्व	pred_false
dayitvon	दायित्वों	दायतत्वों	pred_false
dayityon	दायित्वों	दायतियों	pred_false
darul	दारूल	दरुल	pred_false
daav	दाव	दाव	pred_true
daaw	दाव	डाव	pred_false
dav	दाव	डाव	pred_false
daw	दाव	डा	pred_false
daah	दाह	दाह	pred_true
dah	दाह	डाह	pred_false
dikhla	दिखला	दिखला	pred_true
dikhlaa	दिखला	दिखला	pred_true
dikhaaiye	दिखाइये	दिखाइए	pred_false
dikhaiye	दिखाइये	दिखाइए	pred_false
dikhaai	दिखाई	दिखाई	pred_true
dikhai	दिखाई	दिखाई	pred_true
dikhayi	दिखाई	दिखाई	pred_true
dikhaaee	दिखाईं	दिखाई	pred_false
dikhaai	दिखाईं	दिखाई	pred_false
dikhaain	दिखाईं	दिखाइं	pred_false
dikhaee	दिखाईं	दिखाई	pred_false
dikhai	दिखाईं	दिखाई	pred_false
dikhayin	दिखाईं	दिखाइं	pred_false
dikhai	दिखायी	दिखाई	pred_false
dikhayi	दिखायी	दिखाई	pred_false
dikhaai	दिखार्इ	दिखाई	pred_false
dikhae	दिखार्इ	दिखाए	pred_false
dikhai	दिखार्इ	दिखाई	pred_false
dikhayi	दिखार्इ	दिखाई	pred_false
dita	दिता	दीता	pred_false
ditaa	दिता	दिता	pred_true
dinaank	दिनांक	दिनांक	pred_true
dinank	दिनांक	दिनांक	pred_true
dirham	दिरहम	दीरहम	pred_false
dilaaye	दिलाये	दिलाए	pred_false
dilaye	दिलाये	दिलाए	pred_false
deewani	दिवानी	दीवानी	pred_false
diwani	दिवानी	दीवानी	pred_false
divy	दिव्य	दिव्य	pred_true
divya	दिव्य	दिव्य	pred_true
divyata	दिव्यता	दिव्यता	pred_true
divya	दिव्या	दिव्य	pred_false
deepan	दीपन	दीपान	pred_false
deepn	दीपन	डीपन	pred_false
dipan	दीपन	दिपान	pred_false
deepsingh	दीपसिंह	डीप्सिंह	pred_false
dipsingh	दीपसिंह	डिप्सिंह	pred_false
deepika	दीपिका	दीपिका	pred_true
dipika	दीपिका	दिपिका	pred_false
deeya	दीया	दीया	pred_true
diya	दीया	दिया	pred_false
dukaanon	दुकानों	दूकानों	pred_false
dukanon	दुकानों	दूकानों	pred_false
dukke	दुक्के	डुक्के	pred_false
dukhan	दुखन	दूखान	pred_false
dukhit	दुखित	दुखित	pred_true
dukhiyon	दुखियों	दूखियों	pred_false
dukhon	दुखों	दूखों	pred_false
dubhashiyon	दुभाषियों	दुभाषियों	pred_true
durgun	दुर्गुण	दुर्गुण	pred_true
durghatna	दुर्घटना	दुर्घटना	pred_true
durghtna	दुर्घटना	दुर्घटना	pred_true
duneerti	दुर्नीति	दुनीर्ति	pred_false
durniti	दुर्नीति	दूर्णिति	pred_false
durbhiksh	दुर्भिक्ष	दुर्भिक्ष	pred_true
duvidhaaen	दुविधाएं	दुविधाएं	pred_true
duvidhaayein	दुविधाएं	दुविधाएं	pred_true
duvidhaen	दुविधाएं	दुविधाएं	pred_true
duwaidhaayein	दुविधाएं	दुवाधाएं	pred_false
dune	दूने	दुने	pred_false
doordarshan	दूरदर्शन	दूरदर्शन	pred_true
durdarshan	दूरदर्शन	दूरदर्शन	pred_true
dradh	दृढ़	द्राद	pred_false
dridh	दृढ़	दृद्ध	pred_false
dekhoge	देखोगे	देखोगे	pred_true
denevaali	देनेवाली	देनेवाली	pred_true
denevali	देनेवाली	देनेवाली	pred_true
denewaali	देनेवाली	देनवाली	pred_false
denewali	देनेवाली	देनेवाली	pred_true
deonar	देवनार	डियोनर	pred_false
devnaar	देवनार	देवनार	pred_true
devnar	देवनार	देवनार	pred_true
devaapur	देवापुर	देवापुर	pred_true
devapur	देवापुर	देवापुर	pred_true
devi	देवी	देवी	pred_true
devisingh	देवीसिंह	डेविसिंह	pred_false
devisinh	देवीसिंह	डेविसिंह	pred_false
deshkaal	देशकाल	देशकाल	pred_true
deshkal	देशकाल	देशकाल	pred_true
deshke	देशके	देशके	pred_true
desai	देसाई	देसाई	pred_true
doge	दोगे	डोग	pred_false
dvadash	द्वादश	द्वादश	pred_true
dwaadas	द्वादश	द्वादस	pred_false
dvivedi	द्विवेदी	द्विवेदी	pred_true
dwivedi	द्विवेदी	द्विवेदी	pred_true
dhande	धंधे	ढंडे	pred_false
dhandhe	धंधे	ढांढे	pred_false
dhndhe	धंधे	ढाधे	pred_false
dhandhon	धंधों	धंधों	pred_true
dhandon	धंधों	धंडों	pred_false
dhakelte	धकेलते	ढकेलते	pred_false
dhkelate	धकेलते	ढकेलते	pred_false
dhatana	धटना	ढाना	pred_false
dhatna	धटना	ढाटना	pred_false
dhankuber	धनकुबेर	धंकुबर	pred_false
dhanadhany	धनधान्य	धनधान्य	pred_true
dhandhaanya	धनधान्य	धंधान्य	pred_false
dhandhany	धनधान्य	धंधन्य	pred_false
dhandhanya	धनधान्य	धंधन्य	pred_false
dhamkaataa	धमकाता	धमकाता	pred_true
dhamkata	धमकाता	धमकता	pred_false
dhamm	धम्म	धम्म	pred_true
dhamma	धम्मा	धम्मा	pred_true
dhammaa	धम्मा	धम्मा	pred_true
dharmnath	धर्मनाथ	धर्मनाथ	pred_true
dharmraj	धर्मराज	धर्मराज	pred_true
dharmesh	धर्मेश	धर्मेश	pred_true
dhasmaanaa	धस्माना	धस्माना	pred_true
dhasmana	धस्माना	धाम्माना	pred_false
dhaak	धाक	ढाक	pred_false
dhak	धाक	ढाक	pred_false
dhaaga	धागा	धागा	pred_true
dhaagaa	धागा	ढागा	pred_false
dhaga	धागा	ढागा	pred_false
dhaatuein	धातुएं	धातुएं	pred_true
dhaatuyein	धातुएं	धातुएं	pred_true
dhtuen	धातुएं	धत्यूं	pred_false
dhaarak	धारक	धारक	pred_true
dharak	धारक	धारक	pred_true
dhaari	धारी	धारी	pred_true
dhari	धारी	धारी	pred_true
dhuan	धुआं	धुआन	pred_false
dhunaai	धुनाई	धुनाई	pred_true
dhunai	धुनाई	धुनई	pred_false
dhuriya	धुरिया	धूरिया	pred_false
dhuriyaa	धुरिया	धुरिया	pred_true
dhuni	धूनी	धूनी	pred_true
dhairyavaan	धैर्यवान	धैर्यवान	pred_true
dhairyawan	धैर्यवान	धैर्यान	pred_false
dhiryavan	धैर्यवान	धीर्यन	pred_false
dhiryawaan	धैर्यवान	धीर्यवान	pred_false
dhokebaaj	धोखेबाज	धोकेबाज	pred_false
dhokebaaz	धोखेबाज	धोकेबाज	pred_false
dhokebaj	धोखेबाज	धोकेबाज	pred_false
dhokebaz	धोखेबाज	धोकेबाज	pred_false
dhokhebaaj	धोखेबाज	धोखेबाज	pred_true
dhokhebaj	धोखेबाज	धोखेबाज	pred_true
dhona	धोना	ढोना	pred_false
dhonaa	धोना	ढोना	pred_false
dhoraaji	धोराजी	धोराजी	pred_true
dhoraji	धोराजी	धोराजी	pred_true
dhoron	धोरों	धोरों	pred_true
dhyeyavaadi	ध्येयवादी	ध्येवादी	pred_false
dhyeywadi	ध्येयवादी	ध्येवादी	pred_false
dyeyvadi	ध्येयवादी	द्येवादी	pred_false
dhrupad	ध्रुपद	धृपुद	pred_false
drupad	ध्रुपद	द्रुपद	pred_false
nandanvan	नंदनवन	नंदनवान	pred_false
nadsa	नक्सल	नाससा	pred_false
naksal	नक्सल	नक्सल	pred_true
naxal	नक्सल	नकस्कल	pred_false
naksalavaad	नक्सलवाद	नक्सलावाद	pred_false
naksalwaad	नक्सलवाद	नक्सलवाद	pred_true
naksalwad	नक्सलवाद	नक्सलवाद	pred_true
naxalvaaad	नक्सलवाद	नक्सल्वाद	pred_false
naxalwaad	नक्सलवाद	नक्सल्वाद	pred_false
naksaliyon	नक्सलियों	नक्सलियों	pred_true
naxaliyon	नक्सलियों	नक्सलियों	pred_true
naksali	नक्सली	नक्सली	pred_true
naxali	नक्सली	नक्सली	pred_true
nagaada	नगाड़ा	नगाड़ा	pred_true
nagaadaa	नगाड़ा	नगाड़ा	pred_true
nagaaraa	नगाड़ा	नगारा	pred_false
nageene	नगीने	नगीने	pred_true
nagine	नगीने	नागिन	pred_false
najarandaaj	नजरंदाज	नजरअंदाज	pred_false
najarandaaz	नजरंदाज	नजरअंदाज	pred_false
nazarandaaj	नजरंदाज	नज़रंदाज	pred_false
nazarandaaz	नजरंदाज	नज़रंदाज	pred_false
nazarandaz	नजरंदाज	नज़रंदाज	pred_false
najraane	नजराने	नज़ााने	pred_false
nazraane	नजराने	नज़ारने	pred_false
najariyon	नजरियों	नज़रियों	pred_false
najriyon	नजरियों	नजरियों	pred_true
najron	नजरों	नजरों	pred_true
najeeb	नजीब	नजीब	pred_true
najib	नजीब	नजीब	pred_true
najibabaad	नजीबाबाद	नजीीबाबाद	pred_false
najibabad	नजीबाबाद	नाजीबाबाद	pred_false
najeem	नजीम	नजीम	pred_true
najim	नजीम	नजीम	pred_true
nazeem	नजीम	नजीम	pred_true
nana	नना	नाना	pred_false
nanaa	नना	नाा	pred_false
nna	नना	न्ना	pred_false
nanhe	नन्हें	नाहें	pred_false
nanhein	नन्हें	नाहहें	pred_false
nabj	नब्ज़	नब्ज	pred_false
nabja	नब्ज़	नब्ज	pred_false
nabz	नब्ज़	नब्ज	pred_false
namkeen	नमकीन	नमकीन	pred_true
namkin	नमकीन	नमकीन	pred_true
narnaari	नरनारी	नर्ारी	pred_false
narnari	नरनारी	नर्ारी	pred_false
narbhakshi	नरभक्षी	नर्भक्षी	pred_false
naram	नरम	नारम	pred_false
narm	नरम	नर्म	pred_false
narmi	नरमी	नर्मी	pred_false
narsanhar	नरसंहार	नरसंहर	pred_false
narsanharon	नरसंहारों	नरसंहारों	pred_true
november	नवंबर	नवरंबर	pred_false
navketan	नवकेतन	नवकेतन	pred_true
navjaagaran	नवजागरण	नवजागरण	pred_true
navjagran	नवजागरण	नवजाग्रण	pred_false
navdha	नवधा	नवधा	pred_true
navvadhoo	नववधू	नववाधू	pred_false
navvadhu	नववधू	नववाधु	pred_false
nava	नवा	नवा	pred_true
navaa	नवा	नवा	pred_true
navate	नवाते	नवाते	pred_true
navanagar	नवानगर	नवागर	pred_false
nawanagar	नवानगर	नवागर	pred_false
navya	नव्या	नव्य	pred_false
naseem	नसीम	नसीम	pred_true
nasim	नसीम	नसीम	pred_true
nights	नाइट्रस	नाइट्स	pred_false
nitrous	नाइट्रस	नाइट्रस	pred_true
nineteez	नाइनटीज	निनीतीज	pred_false
nineties	नाइनटीज	निनेटीज	pred_false
ninties	नाइनटीज	निटीज	pred_false
nau	नाऊ	ना	pred_false
nauu	नाऊ	नौ	pred_false
naakaam	नाकाम	नाकाम	pred_true
nakam	नाकाम	नकम	pred_false
naagrik	नागारिक	नागरिक	pred_false
nagarik	नागारिक	नागरिक	pred_false
nagrik	नागारिक	नागरिक	pred_false
nagin	नागिन	नगीन	pred_false
nadep	नाडेप	नेड़प	pred_false
nanak	नानक	ननक	pred_false
nanavati	नानावती	ननावती	pred_false
napane	नापने	नापने	pred_true
napne	नापने	नापने	pred_true
napa	नापा	नापा	pred_true
naam	नाम	नाम	pred_true
naamdhari	नामधारी	नामधारी	pred_true
namdhari	नामधारी	नामधारी	pred_true
namankano	नामांकनों	नमाकनों	pred_false
namankanon	नामांकनों	नमाकाणों	pred_false
namavaliyon	नामावलियों	नमावलियों	pred_false
naamo	नामो	नामो	pred_true
namo	नामो	नमो	pred_false
nayak	नायक	नायक	pred_true
naraji	नाराजी	नाराजी	pred_true
naraingarh	नारायणगढ़	नाराइंगढ़	pred_false
narayangadh	नारायणगढ़	नारायंगढ़	pred_false
narayangarh	नारायणगढ़	नारायंगढ़	pred_false
naasar	नासर	नासर	pred_true
nahargadh	नाहरगढ	नहर्गढ़	pred_false
nahargarh	नाहरगढ	नहरगढ़	pred_false
nikalegi	निकलेगी	निकलेगी	pred_true
nikalogi	निकलेगी	निकलोगी	pred_false
nikaalani	निकालनी	निकालनी	pred_true
nikaalni	निकालनी	निकालनी	pred_true
nikalani	निकालनी	निकलानी	pred_false
nikalni	निकालनी	निकलनी	pred_false
nicki	निकी	निकी	pred_true
nicky	निकी	निकी	pred_true
niki	निकी	नीकी	pred_false
niketan	निकेतन	निकेटन	pred_false
nikhar	निखर	निखार	pred_false
nikhari	निखरी	निखाी	pred_false
nigar	निगर	निगार	pred_false
nigger	निगर	नागर	pred_false
nichala	निचला	निचला	pred_true
nichalaa	निचला	निचला	pred_true
nichla	निचला	निच्ला	pred_false
nitiyon	नितियों	नीतियों	pred_false
nitya	नित्या	नित्य	pred_false
nityaa	नित्या	नित्या	pred_true
nidhaan	निधान	निधान	pred_true
nidhan	निधान	निधान	pred_true
nipatara	निपटारा	निपटारा	pred_true
niptaara	निपटारा	निपटारा	pred_true
niptaaraa	निपटारा	निपटारा	pred_true
niptara	निपटारा	निपटारा	pred_true
niyanta	नियंता	नियंता	pred_true
niyantaa	नियंता	नियंता	pred_true
niya	निया	निया	pred_true
niyaa	निया	निया	pred_true
nirdeshika	निर्देशिका	निर्देशिका	pred_true
nirdeshikaa	निर्देशिका	निर्देशिका	pred_true
nirdhaarit	निर्धारित	निर्धारित	pred_true
nirdharit	निर्धारित	निर्धारित	pred_true
nirbaadh	निर्बाध	निर्बाध	pred_true
nirbadh	निर्बाध	निर्बद्ध	pred_false
niveshakartaa	निवेशकर्ता	निवेशकार्ता	pred_false
niveshkarta	निवेशकर्ता	निवेशकर्ता	pred_true
niveshkartaa	निवेशकर्ता	निवेशकर्ता	pred_true
nischal	निश्चल	निच्छल	pred_false
nishchal	निश्चल	निष्चल	pred_false
nishnaat	निष्णात	निष्णात	pred_true
nishpaap	निष्पाप	निष्पाप	pred_true
nihalaani	निहलानी	निहलानी	pred_true
nihlaani	निहलानी	निहलानी	pred_true
nihlani	निहलानी	निहलनी	pred_false
nihaalchand	निहालचंद	निहालचंद	pred_true
nihalchand	निहालचंद	निहलचंद	pred_false
neechaaee	नीचाई	नीछाई	pred_false
nichaai	नीचाई	निचाई	pred_false
neat	नीट	नीट	pred_true
neet	नीट	नीत	pred_false
neetiyon	नीतियों	नीतियों	pred_true
nitiyon	नीतियों	नीतियों	pred_true
neelagaay	नीलगाय	नीलगाय	pred_true
nilgai	नीलगाय	निलगाई	pred_false
neelaabh	नीलाभ	नीलाभ	pred_true
nilaabh	नीलाभ	निलाभ	pred_false
nilabh	नीलाभ	निलाभ	pred_false
nuskhe	नुस्खे	नुख्खे	pred_false
noon	नून	नून	pred_true
nun	नून	नन	pred_false
noobiyaa	नूबिया	नूबिया	pred_true
nubiya	नूबिया	नुबिया	pred_false
nrityashaili	नृत्यशैली	नृत्यशाली	pred_false
nrutyashaili	नृत्यशैली	नृत्यशाली	pred_false
nrityon	नृत्यों	नृत्यों	pred_true
nrutyon	नृत्यों	नृत्यों	pred_true
neco	नेको	नेको	pred_true
neko	नेको	नेको	pred_true
nectar	नेक्टर	नेक्टार	pred_false
neg	नेग	नेग	pred_true
nega	नेग	नेगा	pred_false
networking	नेटवर्किग	नेटवर्किंग	pred_false
neto	नेटो	नेटो	pred_true
neta	नेता	नेता	pred_true
nemo	नेमो	नेमो	pred_true
nelsan	नेल्सन	नेल्सन	pred_true
nelson	नेल्सन	नेल्सन	pred_true
nations	नेशंस	नाटेंस	pred_false
nehara	नेहरा	नेहरा	pred_true
nehra	नेहरा	नेहरा	pred_true
naino	नैनो	नैनो	pred_true
nano	नैनो	नानो	pred_false
naivedh	नैवेद्य	नैवेध	pred_false
naivegh	नैवेद्य	नैवेग	pred_false
nevedya	नैवेद्य	नेवद्य	pred_false
nominate	नॉमिनेट	नोमीनेट	pred_false
naukari	नोकरी	नौकरी	pred_false
naukri	नोकरी	नौकरी	pred_false
nokari	नोकरी	नोकरी	pred_true
nokri	नोकरी	नोकरी	pred_true
notes	नोट्स	नोट्स	pred_true
nora	नोरा	नोरा	pred_true
nori	नोरी	नोरी	pred_true
nauner	नौनेर	नौनर	pred_false
nauvahan	नौवहन	नौवहन	pred_true
naushad	नौशाद	नौषद	pred_false
panchaang	पंचांग	पंचांग	pred_true
panchang	पंचांग	पंचांग	pred_true
punchang	पंचांग	पंचांग	pred_true
punjab	पंजाब	पंजबब	pred_false
punjabiyon	पंजाबियों	पंजाबियों	pred_true
pantar	पंटर	पंतर	pred_false
panter	पंटर	पंटर	pred_true
punter	पंटर	पंटर	pred_true
pakaayein	पकाएं	पकाएं	pred_true
pakaayen	पकाएं	पकाएं	pred_true
pakaen	पकाएं	पकाएं	pred_true
pakayen	पकाएं	पकाएं	pred_true
pakaude	पकौड़े	पकौड़े	pred_true
pakshapat	पक्षपात	पक्षापत	pred_false
pakshpaat	पक्षपात	पक्षपात	pred_true
pakshpat	पक्षपात	पक्षपपत	pred_false
pagabadha	पगबाधा	पगबद्ध	pred_false
pagbadha	पगबाधा	पगबद्धा	pred_false
pagalaa	पगला	पगला	pred_true
pagla	पगला	पगला	pred_true
pachaataa	पचाता	पचाता	pred_true
pachata	पचाता	पचाता	pred_true
patakkar	पटककर	पटककर	pred_true
patkathaayein	पटकथाएं	पटकथाएं	pred_true
patkathaein	पटकथाएं	पटकथाएं	pred_true
patkathayen	पटकथाएं	पटकथाएं	pred_true
patki	पटकी	पटकी	pred_true
pataraani	पटरानी	पतरानी	pred_false
patrani	पटरानी	पत्रणणी	pred_false
patavaari	पटवारी	पटवारी	pred_true
patwari	पटवारी	पटवाड़ी	pred_false
pataakshep	पटाक्षेप	पताक्षेप	pred_false
patachep	पटाक्षेप	पतचछेप	pred_false
patakshep	पटाक्षेप	पतकक्षेप	pred_false
patiya	पटिया	पटिया	pred_true
patiyaa	पटिया	पटिया	pred_true
padaraunaa	पडरौना	पदरौणा	pred_false
padrauna	पडरौना	पद्रौणा	pred_false
padega	पड़ेगा	पड़ेगा	pred_true
padegaa	पड़ेगा	पदेगा	pred_false
padha	पढ़ा	पढ़ा	pred_true
padhaa	पढ़ा	पढ़ा	pred_true
padhaataa	पढ़ाता	पढ़ता	pred_false
padhata	पढ़ाता	पढ़ता	pred_false
patili	पतीली	पतिली	pred_false
padamawati	पदमावती	पदमावटी	pred_false
padmavati	पदमावती	पद्मावती	pred_false
padmawati	पदमावती	पद्मावती	pred_false
padadhikari	पदाधिकारी	पदाधिकारी	pred_true
panapnaa	पनपना	पनपना	pred_true
panpana	पनपना	पापना	pred_false
panaamaa	पनामा	पनामा	pred_true
panama	पनामा	पन्मा	pred_false
paneer	पनीर	पाीर	pred_false
pammi	पम्मी	पामी	pred_false
pammu	पम्मी	पम्मू	pred_false
pummi	पम्मी	पुम्मी	pred_false
pummy	पम्मी	पम्मी	pred_true
pardesiyon	परदेसियों	पर्देशियों	pred_false
pardesi	परदेसी	पर्देसी	pred_false
parva	परवा	पर्व	pred_false
parvaa	परवा	परवा	pred_true
parwa	परवा	परवा	pred_true
parwaa	परवा	परवा	pred_true
paraadheen	पराधीन	पराधीन	pred_true
paraadhin	पराधीन	पराधीन	pred_true
paradheen	पराधीन	पराधीन	pred_true
paradhin	पराधीन	पराधीन	pred_true
parikalpit	परिकल्पित	परिकल्पित	pred_true
parimal	परिमल	परिमाल	pred_false
parishad	परिषद	परिषाद	pred_false
parishadiy	परिषदीय	परिशादीय	pred_false
parishadiya	परिषदीय	परिशदीय	pred_false
parishadon	परिषदों	परिशदों	pred_false
parikhaen	परीक्षाएं	परिखाएं	pred_false
parikshaayein	परीक्षाएं	परिक्षाएं	pred_false
parikshaen	परीक्षाएं	परिक्षाएं	pred_false
parosane	परोसने	परोसने	pred_true
parosne	परोसने	परोसने	pred_true
parda	पर्दा	परदा	pred_false
pardaa	पर्दा	परदा	pred_false
purple	पर्पल	पर्पल	pred_true
palatne	पलटने	पलतने	pred_false
paltane	पलटने	पलताने	pred_false
palaari	पलारी	पलारी	pred_true
palari	पलारी	पलारी	pred_true
pale	पले	पाले	pred_false
palmonari	पल्मोनरी	पल्मोनारी	pred_false
pulmonary	पल्मोनरी	पुल्मोनरी	pred_false
plus	पल्स	प्लस	pred_false
pulse	पल्स	पुल्स	pred_false
pashtun	पश्तून	पष्टुन	pred_false
pashtuun	पश्तून	पश्तुओं	pred_false
pahan	पहन	पहन	pred_true
pehan	पहन	पहन	pred_true
pahantaa	पहनता	पहनता	pred_true
pahnata	पहनता	पहनता	pred_true
pehnate	पहनता	पहनाते	pred_false
pahanate	पहनते	पहनते	pred_true
pahante	पहनते	पहाते	pred_false
pehnate	पहनते	पहनाते	pred_false
pahnaakar	पहनाकर	पहनाकर	pred_true
pahnakar	पहनाकर	पहनकार	pred_false
pehnakar	पहनाकर	पहनकार	pred_false
pahnaati	पहनाती	पहनती	pred_false
pahnati	पहनाती	पहनती	pred_false
pehnati	पहनाती	पहनती	pred_false
pahani	पहनी	पहानी	pred_false
pahni	पहनी	पहनी	pred_true
pehni	पहनी	पहनी	pred_true
pahno	पहनो	पहनों	pred_false
pehno	पहनो	पहनो	pred_true
pahla	पहला	पहला	pred_true
pahlaa	पहला	पहला	pred_true
pehla	पहला	पहला	pred_true
paheliyaan	पहेलियां	पहेलियां	pred_true
paheliyan	पहेलियां	पहेलियां	pred_true
paheliyon	पहेलियों	पहेलियों	pred_true
pide	पाइड	पीढ़े	pred_false
pied	पाइड	पाइड	pred_true
pythagoras	पाइथागोरस	पिथागोरास	pred_false
pythogaras	पाइथागोरस	प्थोगारास	pred_false
paakhandi	पाखंडी	पाखंडी	pred_true
pakhandi	पाखंडी	पखांडी	pred_false
paathshaalaayein	पाठशालाएं	पठठशालाएं	pred_false
pathshalayein	पाठशालाएं	पठसशालाएं	pred_false
pathshalayen	पाठशालाएं	पथसशालाएं	pred_false
paathyakram	पाठ्यक्रम	पाठयक्रम	pred_false
pathyakram	पाठ्यक्रम	पथ्यक्रम	pred_false
pathykram	पाठ्यक्रम	पाठ्ककर	pred_false
paathyakramon	पाठ्यक्रमों	पाठ्यक्रमों	pred_true
pathyakramon	पाठ्यक्रमों	पाठ्यक्रमों	pred_true
pathykramon	पाठ्यक्रमों	पाठ्यकर्मों	pred_false
population	पापुलेशन	पॉपुलेशन	pred_false
pailot	पायलट	पैलोट	pred_false
pilot	पायलट	पिलोट	pred_false
pailoton	पायलटों	पैलोटों	pred_false
piloton	पायलटों	पिलोतों	pred_false
paarampariktaa	पारंपरिकता	पारंपरिकता	pred_true
paramparikata	पारंपरिकता	पारमपरिकता	pred_false
paramparikta	पारंपरिकता	पारंपरिकता	pred_true
parnel	पार्नेल	परर्ल	pred_false
parnell	पार्नेल	पार्नल	pred_false
parleron	पार्लरों	पार्लरों	pred_true
parloron	पार्लरों	पार्लों	pred_false
parlouron	पार्लरों	पार्लों	pred_false
paarshad	पार्षद	पारशशद	pred_false
parshad	पार्षद	पर्शद	pred_false
paarshadon	पार्षदों	पार्शदों	pred_false
parshadon	पार्षदों	पर्शदों	pred_false
parshdon	पार्षदों	पर्शदों	pred_false
policy	पालिसी	पोलिसी	pred_false
pinta	पिंटा	पिंटा	pred_true
pintaa	पिंटा	पिंटा	pred_true
piega	पिएगा	पीएगा	pred_false
piyegaa	पिएगा	पियेगा	pred_false
pic	पिक	पिक	pred_true
pick	पिक	पिक	pred_true
pik	पिक	पीक	pred_false
piki	पिकी	पीकी	pred_false
piky	पिकी	पीकी	pred_false
picture	पिक्चर	पिक्चर	pred_true
pigmentation	पिगमेंटेशन	पिगेमंटशशन	pred_false
pigs	पिग्स	पिग्स	pred_true
pichde	पिछड़े	पीछड़े	pred_false
pichhade	पिछड़े	पिछड़े	pred_true
pijja	पिज्जा	पिज्जा	pred_true
pizza	पिज्जा	पिज़ा	pred_false
pitaamaha	पितामह	पीतामह	pred_false
pitamah	पितामह	पीतामह	pred_false
pipra	पिपरा	पिप्र	pred_false
pipraa	पिपरा	पिपरा	pred_true
pipli	पिपली	पिपली	pred_true
pearson	पियरसन	पर्सन	pred_false
pierson	पियरसन	पियरसन	pred_true
peary	पियरी	पीरी	pred_false
piyari	पियरी	पियारी	pred_false
pisaai	पिसाई	पिसाई	pred_true
pisai	पिसाई	पिसाई	pred_true
pihaani	पिहानी	पिहानी	pred_true
pihani	पिहानी	पिहानी	pred_true
pib	पीआईबी	पिब	pred_false
pr	पीआर	पीआर	pred_true
pml	पीएमएल	पीएमएल	pred_true
pmo	पीएमओ	प्मो	pred_false
pmch	पीएमसीएच	पीएचचच	pred_false
psv	पीएसवी	पीएसवी	pred_true
peaking	पीकिंग	पीकिंग	pred_true
picking	पीकिंग	पिकिंग	pred_false
peetne	पीटने	पीटने	pred_true
pitne	पीटने	पीतने	pred_false
pedia	पीडिया	पेड़िया	pred_false
pidiya	पीडिया	पीड़िया	pred_false
pidiyaa	पीडिया	पिड़िया	pred_false
peelepan	पीलेपन	पीलेपन	pred_true
pilepan	पीलेपन	पिलेपन	pred_false
pv	पीवी	पीवी	pred_true
pisa	पीसा	पीसा	pred_true
putla	पुतला	पुतला	pred_true
putlaa	पुतला	पुतला	pred_true
putaliyaan	पुतलियां	पुटलियां	pred_false
putliyan	पुतलियां	पुटलियां	pred_false
putaliyon	पुतलियों	पुतलियों	pred_true
putliyon	पुतलियों	पुतलियों	pred_true
putali	पुतली	पुतली	pred_true
putli	पुतली	पुतली	pred_true
putale	पुतले	पुतले	pred_true
putle	पुतले	पूटल	pred_false
putin	पुतिन	पुटिन	pred_false
putul	पुतुल	पुटुल	pred_false
punargathan	पुनर्गठन	पुनर्गठन	pred_true
puna	पुना	पुना	pred_true
puraane	पुराने	पुराने	pred_true
purane	पुराने	पुराने	pred_true
puru	पुरू	पुरु	pred_false
purjon	पुर्जों	पूर्जों	pred_false
purzon	पुर्जों	पूर्जों	pred_false
pulam	पुलम	पुलम	pred_true
pushkin	पुश्किन	पुष्किन	pred_false
pushkarana	पुष्करणा	पुष्करण	pred_false
pushkarna	पुष्करणा	पुष्करण	pred_false
pushkarnaa	पुष्करणा	पुष्करण	pred_false
pushp	पुष्प	पुष्प	pred_true
pushpa	पुष्प	पुष्प	pred_true
pushpa	पुष्पा	पुष्प	pred_false
pushpaa	पुष्पा	पुष्पा	pred_true
pushpit	पुष्पित	पुष्पित	pred_true
pushpon	पुष्पों	पुष्पों	pred_true
poonjikaran	पूंजीकरण	पूंजीकरण	pred_true
punjikaran	पूंजीकरण	पुंजीकरण	pred_false
poojaapaath	पूजापाठ	पूजापाठ	pred_true
poojapath	पूजापाठ	पूजापाठ	pred_true
pujapath	पूजापाठ	पूजापाठ	pred_true
pooranpur	पूरनपुर	पूराणपुर	pred_false
puranpur	पूरनपुर	पुराणपुर	pred_false
purvaabhaas	पूर्वाभास	पूर्वाभास	pred_true
purvaabhas	पूर्वाभास	पूर्वाभास	pred_true
purvabhaas	पूर्वाभास	पूर्वाभास	pred_true
purvabhas	पूर्वाभास	पूर्वाभास	pred_true
pendulam	पेंडुलम	पेंदुलम	pred_false
pendulum	पेंडुलम	पैंडुलम	pred_false
peg	पेग	पेग	pred_true
pages	पेजेज	पेग्स	pred_false
pajej	पेजेज	पजेज	pred_false
pace	पेस	पेस	pred_true
pes	पेस	पेस	pred_true
pastry	पेस्ट्री	पास्ट्री	pred_false
pangolin	पैंगोलिन	पंगोलिन	pred_false
pengolin	पैंगोलिन	पेंगोलिन	pred_false
packard	पैकर्ड	पैकार्ड	pred_false
package	पैकेज	पैकेज	pred_true
packageon	पैकेजों	पैकेजियों	pred_false
packagon	पैकेजों	पैकागों	pred_false
packajon	पैकेजों	पकाजों	pred_false
paim	पैम	पैम	pred_true
pam	पैम	पैम	pred_true
paratrooper	पैराट्रूपर	पारत्र	pred_false
peratrupers	पैराट्रूपर	पराटरपर्स	pred_false
paranormal	पैरानॉर्मल	पारानोर्मल	pred_false
peranormal	पैरानॉर्मल	पेरानर्मल	pred_false
paraffin	पैराफिन	पराफीन	pred_false
parafin	पैराफिन	पराफीन	pred_false
perafin	पैराफिन	पेराफिन	pred_false
parabola	पैराबोला	पराबोला	pred_false
perabola	पैराबोला	पररोलो	pred_false
polimer	पॉलिमर	पॉलीमर	pred_false
polymer	पॉलिमर	पॉलिमर	pred_true
polishing	पॉलिशिंग	पोलिशिंग	pred_false
pokar	पोकर	पोकर	pred_true
poker	पोकर	पोकर	pred_true
polish	पोलिश	पोलिश	pred_true
poshit	पोषित	पोषित	pred_true
posta	पोस्ता	पोस्त	pred_false
pau	पौ	पौ	pred_true
pyade	प्यादे	प्यादे	pred_true
prakriya	प्रक्रिया	प्रक्रिया	pred_true
prakshepak	प्रक्षेपक	प्रक्षेपक	pred_true
pratigya	प्रतिज्ञा	प्रतिज्ञ	pred_false
prtigyaa	प्रतिज्ञा	प्रतिज्ञा	pred_true
pratibhutiyan	प्रतिभूतियां	प्रतिभूतियां	pred_true
pratiyon	प्रतियों	प्रतियों	pred_true
prativaad	प्रतिवाद	प्रतिवाद	pred_true
prativad	प्रतिवाद	प्रतिवाद	pred_true
prativadi	प्रतिवादी	प्रतिवादी	pred_true
pratishat	प्रतिशत	प्रतिष्ट	pred_false
praneet	प्रनीत	प्रणीत	pred_false
pranit	प्रनीत	प्रणीत	pred_false
prapaat	प्रपात	प्रपात	pred_true
prapat	प्रपात	प्रपात	pred_true
prapaaton	प्रपातों	प्रपातों	pred_true
prapaton	प्रपातों	प्रपटों	pred_false
prabodhini	प्रबोधिनी	प्रबोधिनी	pred_true
prayaasrat	प्रयासरत	प्रयासरत	pred_true
prayasarat	प्रयासरत	प्रयासरत	pred_true
pradarshan	प्रर्दशन	प्रदर्शन	pred_false
prardashan	प्रर्दशन	प्रर्दशान	pred_false
pravati	प्रवत्ति	प्रवती	pred_false
pravatti	प्रवत्ति	प्रवत्ति	pred_true
prashaasanik	प्रशासनिक	प्रशासानिक	pred_false
prashasanik	प्रशासनिक	प्रशासानिक	pred_false
prashasnik	प्रशासनिक	प्रशास्निक	pred_false
prashaasanon	प्रशासनों	प्रशासनों	pred_true
prashansanon	प्रशासनों	प्रशंसनों	pred_false
prashasanon	प्रशासनों	प्रशासनों	pred_true
prashikshu	प्रशिक्षु	प्रशिक्षु	pred_true
prastaavon	प्रस्तावों	प्रस्तावों	pred_true
prastavon	प्रस्तावों	प्रस्तवों	pred_false
prahlaad	प्रहलाद	प्रहलाद	pred_true
prahlad	प्रहलाद	प्रहलाद	pred_true
prahasan	प्रहसन	प्रहसन	pred_true
prahsan	प्रहसन	प्रहसन	pred_true
prahaarak	प्रहारक	प्रहारक	pred_true
praharak	प्रहारक	प्रहरक	pred_false
prahad	प्रह्लाद	प्रहाद	pred_false
prahlad	प्रह्लाद	प्रहलाद	pred_false
privacy	प्राइवेसी	प्रिवासी	pred_false
praakkathan	प्राक्कथन	प्राक्ठान	pred_false
prakkathan	प्राक्कथन	प्रक्तान	pred_false
praan	प्राण	प्राण	pred_true
pran	प्राण	प्रण	pred_false
pranon	प्राणों	प्रणों	pred_false
prathamik	प्राथमिक	प्रााममिक	pred_false
prathmik	प्राथमिक	प्राथमिक	pred_true
praathmikata	प्राथमिकता	प्राथमिकता	pred_true
prathmikta	प्राथमिकता	प्राथमिकता	pred_true
prathmiki	प्राथमिकी	प्रथामिकी	pred_false
pradhyapakon	प्राध्यापकों	प्रध्यापकों	pred_false
prapt	प्राप्त	प्रप्त	pred_false
prapta	प्राप्त	प्रप्त	pred_false
prapti	प्राप्ती	प्राप्ति	pred_false
praroop	प्रारूप	प्रारूप	pred_true
prarup	प्रारूप	प्रारूप	pred_true
priyamani	प्रियामणि	प्रियमणि	pred_false
proof	प्रूफ	प्रूफ	pred_true
pruf	प्रूफ	प्रुफ	pred_false
prekshakon	प्रेक्षकों	प्रेक्षकों	pred_true
prem	प्रेम	प्रैम	pred_false
premlata	प्रेमलता	प्रेमलता	pred_true
prema	प्रेमा	प्रेमा	pred_true
premi	प्रेमी	प्रीमी	pred_false
profit	प्रॉफिट	प्रोफिट	pred_false
processing	प्रॉसेसिंग	प्रोसससिंग	pred_false
programers	प्रोग्रामर्स	प्रोग्रामर्स	pred_true
programmers	प्रोग्रामर्स	प्रोग्रामर्स	pred_true
programs	प्रोग्रामर्स	प्रोग्रास	pred_false
proto	प्रोटो	प्रोतो	pred_false
propellant	प्रोपेलेंट	प्रोपललेंट	pred_false
propellent	प्रोपेलेंट	प्रोपललेंट	pred_false
praudh	प्रौढ	प्रौढ़	pred_false
proud	प्रौढ	प्रौड	pred_false
plan	प्लेन	प्लैन	pred_false
plane	प्लेन	प्लाने	pred_false
fund	फंड	फंंड	pred_false
funda	फंडा	फूंडा	pred_false
funding	फंडिंग	फंडिंग	pred_true
fandon	फंदों	फांडों	pred_false
fagua	फगुआ	फागुआ	pred_false
fatane	फटने	फटने	pred_true
phatane	फटने	फटने	pred_true
phatne	फटने	फटने	pred_true
fadfadata	फड़फड़ाता	फदफफदाता	pred_false
phadphadata	फड़फड़ाता	फड़फड़ाता	pred_true
fatehgadh	फतेहगढ़	फतेहगढ़	pred_true
fatehgarh	फतेहगढ़	फतेहगढ़	pred_true
fabti	फब्ती	फबती	pred_false
phabti	फब्ती	फबती	pred_false
farse	फरसे	फार्स	pred_false
pharase	फरसे	फरससे	pred_false
pharse	फरसे	फर्स	pred_false
farheen	फरहीन	फरहीन	pred_true
farhin	फरहीन	फ़हीन	pred_false
farth	फर्थ	फर्थ	pred_true
ferth	फर्थ	फर्थ	pred_true
pharth	फर्थ	फर्थ	pred_true
farmion	फर्मिऑन	फर्मियन	pred_false
fermion	फर्मिऑन	फर्मियन	pred_false
firmian	फर्मिऑन	फर्मियन	pred_false
farookhabad	फर्रुखाबाद	फरुखाबाद	pred_false
farrukhabad	फर्रुखाबाद	फरुखाबाद	pred_false
farukhabad	फर्रुखाबाद	फरुखाबाद	pred_false
farookhnagar	फर्रूखनगर	फरुखनगर	pred_false
farrukhnagar	फर्रूखनगर	फररुखनगर	pred_false
farukhnagar	फर्रूखनगर	फरुखनागर	pred_false
falata	फलता	फलता	pred_true
falta	फलता	फलता	pred_true
phalata	फलता	फलता	pred_true
falne	फलने	फलने	pred_true
phalne	फलने	फलने	pred_true
falitarth	फलितार्थ	फलीतरर्थ	pred_false
phalitartha	फलितार्थ	फलीतर्थ	pred_false
falibhoot	फलीभूत	फलीभूत	pred_true
falibhut	फलीभूत	फलीभूत	pred_true
phalibhoot	फलीभूत	फलीभूत	pred_true
favvara	फव्वारा	फववारा	pred_false
fawaara	फव्वारा	फवारा	pred_false
favvare	फव्वारे	फववारे	pred_false
fawaare	फव्वारे	फवारे	pred_false
favvaron	फव्वारों	फववारों	pred_false
fawaaron	फव्वारों	फवारों	pred_false
faisala	फ़ैसला	फैसला	pred_false
faisla	फ़ैसला	फैसला	pred_false
follow	फ़ॉलो	फोलो	pred_false
faansi	फांसी	फांसी	pred_true
fansi	फांसी	फांसी	pred_true
fatama	फातमा	फटमा	pred_false
fatma	फातमा	फटतामा	pred_false
faaf	फाफ	फाफ	pred_true
phaaph	फाफ	फाफ	pred_true
farsi	फारसी	फर्सी	pred_false
forcee	फारसी	फॉर्सी	pred_false
farm	फार्म	फ़मर	pred_false
form	फार्म	फॉर्म	pred_false
farmic	फार्मिक	फार्मिक	pred_true
formic	फार्मिक	फॉर्मिक	pred_false
formulae	फार्मूले	फोर्मूलाई	pred_false
formule	फार्मूले	फ़र्मूल	pred_false
formuley	फार्मूले	फोर्मूले	pred_false
pharmacy	फार्मेसी	फरमासी	pred_false
pharma	फार्मों	फरमा	pred_false
pharmon	फार्मों	फरमों	pred_false
farms	फार्म्स	फर्म्स	pred_false
finger	फिंगर	फाइंगर	pred_false
fikra	फिक्र	फिक्र	pred_true
physician	फिजिशियन	फीजिसियन	pred_false
firti	फिरती	फीरती	pred_false
fisla	फिसला	फिसला	pred_true
fislaa	फिसला	फिसला	pred_true
feeder	फीडर	फीदर	pred_false
fulaaye	फुलाए	फुलाए	pred_true
fulae	फुलाए	फुलाई	pred_false
fulay	फुलाए	फुलाई	pred_false
furti	फूर्ति	फूर्ती	pred_false
phurti	फूर्ति	फूर्ती	pred_false
fus	फूस	फस	pred_false
phoos	फूस	फूस	pred_true
phus	फूस	फूस	pred_true
feka	फेका	फेका	pred_true
fefada	फेफड़ा	फेफड़ा	pred_true
fefda	फेफड़ा	फेफड़ा	pred_true
facial	फेशियल	फैसल	pred_false
fact	फैक्ट	फैक्ट	pred_true
federal	फैडरल	फेडरल	pred_false
failkar	फैलकर	फैलकर	pred_true
failaaiye	फैलाइए	फैलाइए	pred_true
failaea	फैलाइए	फैलाई	pred_false
failaiya	फैलाइए	फैलाया	pred_false
failaiye	फैलाइए	फैलाइए	pred_true
failegi	फैलेगी	फैलेगी	pred_true
font	फॉन्ट	फ़ॉंट	pred_false
fogat	फोगाट	फोगत	pred_false
phogat	फोगाट	फोगत	pred_false
fod	फोड़	फोड़	pred_true
phod	फोड़	फोड़	pred_true
foda	फोड़ा	फोडा	pred_false
fodaa	फोड़ा	फोड़ा	pred_true
phoda	फोड़ा	फोड़ा	pred_true
fode	फोड़े	फोड़	pred_false
phode	फोड़े	फोड़	pred_false
fodo	फोड़ों	फोड़ो	pred_false
fodon	फोड़ों	फोड़ों	pred_true
phodo	फोड़ों	फोड़ो	pred_false
fortis	फोर्टिस	फोर्टिस	pred_true
fusion	फ्यूजन	फसीन	pred_false
fuji	फ्यूजी	फूजी	pred_false
fyuji	फ्यूजी	फ्यूजी	pred_true
francisca	फ्रांसिस्का	फ्रांसिस्का	pred_true
franciska	फ्रांसिस्का	फ्रांसिस्का	pred_true
fransiska	फ्रांसिस्का	फ्रांसिस्का	pred_true
francisco	फ्रांसिस्को	फ्रांसिस्को	pred_true
francisko	फ्रांसिस्को	फ्रांसिस्को	pred_true
fransisko	फ्रांसिस्को	फ्रांसिस्को	pred_true
fringe	फ्रिंज	फ्रिंग	pred_false
friendship	फ्रेंडशिप	फ्रिंदशिप	pred_false
frost	फ्रॉस्ट	फ्रॉस्ट	pred_true
flin	फ्लिन	फ्लिन	pred_true
flynn	फ्लिन	फ्लाइन	pred_false
flesh	फ्लेश	फ्लेश	pred_true
bang	बंग	बंग	pred_true
bung	बंग	बंग	pred_true
bangbandhu	बंगबंधु	बंगबंध	pred_false
bangbhang	बंगभंग	बंगभांग	pred_false
bangash	बंगश	बंगाश	pred_false
bangsh	बंगश	बंगश	pred_true
bantane	बंटने	बंटाने	pred_false
bantne	बंटने	बंटने	pred_true
bandhati	बंधती	बंधती	pred_true
bandhti	बंधती	बंधती	pred_true
bandhan	बंधान	बंधन	pred_false
bandhuon	बंधुओं	बंधुओं	pred_true
bamba	बंबा	बांबा	pred_false
mumba	बंबा	मुंबा	pred_false
bakaayon	बकायों	बकायों	pred_true
bakayon	बकायों	बकायों	pred_true
bakaul	बकौल	बकौल	pred_true
bakoul	बकौल	बकोल	pred_false
baksa	बक्सा	बक्सा	pred_true
baksi	बक्सी	बकसी	pred_false
bakse	बक्से	बकसे	pred_false
bakhshane	बख्शने	बख़्ााने	pred_false
bakhshne	बख्शने	बख़शाने	pred_false
bagad	बगड़	बगड़	pred_true
bagd	बगड़	बगद	pred_false
bageechi	बगीची	बगीची	pred_true
bagichi	बगीची	बगीची	pred_true
bachat	बचत	बचा	pred_false
bachati	बचती	बचाती	pred_false
bachti	बचती	बचती	pred_true
bajana	बजना	बजाना	pred_false
bajrangi	बजरंगी	बजरंगी	pred_true
bajaj	बजाज	बजजाज	pred_false
batalvi	बटालवी	बतलवी	pred_false
badhachadhakar	बढ़ाचढ़ाकर	बढ़चाधकर	pred_false
badata	बढ़ाता	बड़ता	pred_false
badhaataa	बढ़ाता	बढ़ाता	pred_true
badhata	बढ़ाता	बढ़ता	pred_false
badhaati	बढ़ाती	बढ़ाती	pred_true
badhati	बढ़ाती	बढ़ती	pred_false
badhayi	बढ़ायी	बढ़ायी	pred_true
badhav	बढ़ाव	बाधव	pred_false
badhotari	बढ़ोतरी	बाधोतारी	pred_false
badhotri	बढ़ोतरी	बाधोत्री	pred_false
batlaae	बतलाए	बतलाई	pred_false
batlaaye	बतलाए	बतलाए	pred_true
batlae	बतलाए	बतलाई	pred_false
batlaye	बतलाए	बतलाए	pred_true
batlaakar	बतलाकर	बतलाकर	pred_true
batlakar	बतलाकर	बतलाकर	pred_true
badlapur	बदलापुर	बदलापुर	pred_true
badali	बदली	बदली	pred_true
badli	बदली	बदली	pred_true
badam	बदाम	बदादम	pred_false
banva	बनवा	बानवा	pred_false
banvaa	बनवा	बनवा	pred_true
banaam	बनाम	बनाम	pred_true
banam	बनाम	बनाम	pred_true
bnaam	बनाम	बनाम	pred_true
baniya	बनिया	बनिया	pred_true
banu	बनू	बनु	pred_false
barpaayaa	बरपाया	बर्पया	pred_false
barpaya	बरपाया	बर्पया	pred_false
barsa	बरसा	बारसा	pred_false
barsaata	बरसाता	बरसाता	pred_true
barsaataa	बरसाता	बरसाता	pred_true
barsata	बरसाता	बरसता	pred_false
barhad	बरहद	बरहद	pred_true
baraat	बरात	बरात	pred_true
barat	बरात	बरात	pred_true
braat	बरात	ब्रात	pred_false
baraamad	बरामद	बरामदाद	pred_false
baramad	बरामद	बरामद	pred_true
bramad	बरामद	ब्रम्म	pred_false
baramade	बरामदे	बरामड़े	pred_false
baramde	बरामदे	बरामडे	pred_false
bare	बरे	बारे	pred_false
birth	बर्थ	बीर्थ	pred_false
baljeet	बलजीत	बलजीत	pred_true
baljit	बलजीत	बलजीत	pred_true
ballabh	बल्लभ	बल्लभ	pred_true
balla	बल्ला	बल्ला	pred_true
balli	बल्ली	बल्ली	pred_true
basava	बसावा	बसवा	pred_false
bastiyon	बस्तियों	बस्तियों	pred_true
bahroopiya	बहरूपिया	बहरूपिय	pred_false
bahrupiya	बहरूपिया	बहरूपिय	pred_false
bahamaas	बहामास	बहमास	pred_false
bahamas	बहामास	बहमास	pred_false
bahaav	बहाव	बहाव	pred_true
bahav	बहाव	बहाव	pred_true
bhav	बहाव	भाव	pred_false
bahavalpur	बहावलपुर	बहवालपुर	pred_false
bahawalpur	बहावलपुर	बहववलपुर	pred_false
bahuchara	बहुचरा	बहुचारा	pred_false
banthia	बांठिया	बांठिया	pred_true
banthiya	बांठिया	बंठिया	pred_false
bandhate	बांधते	बंधाते	pred_false
bandhte	बांधते	बंधते	pred_false
banbi	बांबी	बांबी	pred_true
bombi	बांबी	बोमबी	pred_false
bounceron	बाउंसरों	बांसरों	pred_false
bowling	बाउलिंग	बोलिंग	pred_false
baku	बाकू	बाकू	pred_true
bakuu	बाकू	बकु	pred_false
baag	बाग	बाग	pred_true
bag	बाग	बग	pred_false
bagh	बाग	बाघ	pred_false
bagabani	बागबानी	बागबानी	pred_true
bagbani	बागबानी	बगगानी	pred_false
bagali	बागली	बगली	pred_false
bagli	बागली	बगली	pred_false
baagiyon	बागियों	बागियों	pred_true
bagiyon	बागियों	बागियों	pred_true
baago	बागो	बागो	pred_true
bago	बागो	बागो	pred_true
baji	बाज़ी	बाजी	pred_false
bazi	बाज़ी	बाजी	pred_false
bajaru	बाजारू	बजारू	pred_false
bazaru	बाजारू	बजारू	pred_false
bajuon	बाजुओं	बजूओं	pred_false
badh	बाध	बाढ़	pred_false
badha	बाधा	बाधा	pred_true
baadhaaon	बाधाओं	बाधाओं	pred_true
baadhaon	बाधाओं	बाधाओं	pred_true
badhaaon	बाधाओं	बढ़ाओं	pred_false
badhaon	बाधाओं	बढ़ाओं	pred_false
baadhit	बाधित	बाधित	pred_true
badhit	बाधित	बाधित	pred_true
baani	बानी	बानी	pred_true
bani	बानी	बानी	pred_true
baapa	बापा	बापा	pred_true
baapaa	बापा	बापा	pred_true
bapa	बापा	बापा	pred_true
bapaa	बापा	बापा	pred_true
baabat	बाबत	बाबत	pred_true
babat	बाबत	बबाबत	pred_false
babt	बाबत	बब्त	pred_false
bayern	बायर्न	बेर्न	pred_false
byrun	बायर्न	ब्रुन	pred_false
barah	बारह	बरहाह	pred_false
baarahamaasee	बारहमासी	बारहमासी	pred_true
barahamasi	बारहमासी	बरहहममसी	pred_false
barahmasi	बारहमासी	बरहहमससी	pred_false
barahsinga	बारहसिंगा	बारहसिंगा	pred_true
barasingha	बारहसिंगा	बरासिंह	pred_false
bala	बाला	बला	pred_false
baalti	बाल्टी	बालती	pred_false
balti	बाल्टी	बलती	pred_false
balty	बाल्टी	बाल्टी	pred_true
baldvin	बाल्डविन	बालद्वीन	pred_false
baldwin	बाल्डविन	बाल्दवीन	pred_false
bavaji	बावजी	बावाजी	pred_false
bavji	बावजी	बावजी	pred_true
baawaraa	बावरा	बावरा	pred_true
bavra	बावरा	बावरा	pred_true
bawara	बावरा	बावरा	pred_true
baahulya	बाहुल्य	बाहुल्य	pred_true
bahuly	बाहुल्य	बहुल्य	pred_false
bahulya	बाहुल्य	बहुल्य	pred_false
box	बाॅक्स	बॉक्स	pred_false
bikherati	बिखेरती	बिखेरती	pred_true
bikherti	बिखेरती	बिखेती	pred_false
biggest	बिगेस्ट	बिगेस्ट	pred_true
bichhua	बिछुआ	बिछुआ	pred_true
bichhuaa	बिछुआ	बिछुआ	pred_true
biji	बिजी	बिजी	pred_true
busy	बिजी	बस्सी	pred_false
buzy	बिजी	बजी	pred_false
bipin	बिपिन	बिपिन	pred_true
bilae	बिलाई	बिलाई	pred_true
bilai	बिलाई	बिलाई	pred_true
billa	बिल्ला	बिल्ला	pred_true
billaa	बिल्ला	बिल्ला	pred_true
bilhaur	बिल्हौर	बिलहहौर	pred_false
bisva	बिस्वा	बिसवा	pred_false
biswa	बिस्वा	बिस्व	pred_false
bag	बीएजी	बग	pred_false
bikaner	बीकानेर	बिकनर	pred_false
bikaneri	बीकानेरी	बिकनेरी	pred_false
bk	बीके	बेक	pred_false
beejak	बीजक	बीजक	pred_true
bijak	बीजक	बिजक	pred_false
beef	बीफ	बीफ	pred_true
beem	बीम	बीम	pred_true
bim	बीम	बिम	pred_false
beemon	बीमों	बीमों	pred_true
bimon	बीमों	बीमोन	pred_false
beerganj	बीरगंज	बीरगंज	pred_true
birganj	बीरगंज	बिरगंज	pred_false
beesavaan	बीसवां	बीसवान	pred_false
bisavan	बीसवां	बिसवान	pred_false
bisawan	बीसवां	बिसवान	pred_false
beast	बीस्ट	बीस्ट	pred_true
budvig	बुडविग	बुड्विग	pred_false
budwig	बुडविग	बुडविग	pred_true
bull	बुल	बुल	pred_true
bulaao	बुलाओ	बुलाओ	pred_true
bulao	बुलाओ	बुलाओ	pred_true
bule	बुले	बुले	pred_true
bulletin	बुलेटिन	बुलेटिन	pred_true
brijesh	बृजेश	बृजेश	pred_true
benvar	बेंवर	बेनवर	pred_false
benwar	बेंवर	बेनवर	pred_false
beaulad	बेऔलाद	बियूलद	pred_false
bekaaboo	बेकाबू	बेकाबू	pred_true
bekabu	बेकाबू	बेकबू	pred_false
bechakar	बेचकर	बेचककर	pred_false
bechkar	बेचकर	बेचकर	pred_true
bechate	बेचते	बेचते	pred_true
bechte	बेचते	बेचते	pred_true
bediyan	बेड़ियां	बेडियां	pred_false
bethanal	बेथनल	बेथनाल	pred_false
bethnal	बेथनल	बेथनाल	pred_false
benis	बेनिस	बेनिस	pred_true
belacha	बेलचा	बेलचा	pred_true
belcha	बेलचा	बेल्चा	pred_false
belinda	बेलिंडा	बेलिंडा	pred_true
bevkufana	बेवकूफाना	बेवकुफना	pred_false
bewakoofaanaa	बेवकूफाना	बेवकूफा	pred_false
bewkufana	बेवकूफाना	बेवकुफाना	pred_false
besahaaraa	बेसहारा	बेसहरा	pred_false
besahara	बेसहारा	बेशहरा	pred_false
basin	बेसिन	बसीन	pred_false
besin	बेसिन	बेसीन	pred_false
basil	बेसिल	बसील	pred_false
besil	बेसिल	बेसिल	pred_true
bandage	बैंडेज	बंदगे	pred_false
bandej	बैंडेज	बंदेज	pred_false
baithantey	बैठते	बैठनते	pred_false
baithate	बैठते	बैठते	pred_true
baitool	बैतूल	बैतूल	pred_true
baitul	बैतूल	बैतुल	pred_false
betul	बैतूल	बेटुल	pred_false
baini	बैनी	बैनी	pred_true
beni	बैनी	बेनी	pred_false
bairakpur	बैरकपुर	बैरकपुर	pred_true
barrackpore	बैरकपुर	बार्केपोर	pred_false
baila	बैला	बैला	pred_true
bella	बैला	बेला	pred_false
ballistic	बैलिस्टिक	बाल्लिस्टिक	pred_false
bells	बैल्स	बेल्स	pred_false
bostan	बॉस्टन	बोस्तान	pred_false
bosten	बॉस्टन	बोस्टन	pred_false
boston	बॉस्टन	बोस्टन	pred_false
bokaro	बोकारो	बोकारो	pred_true
bodara	बोदरा	बोड़रा	pred_false
bodra	बोदरा	बोदरा	pred_true
bodraa	बोदरा	बोदरा	pred_true
bona	बोना	बोना	pred_true
borkar	बोरकर	बोरकर	pred_true
borivali	बोरीवली	बोरीवाली	pred_false
boriwali	बोरीवली	बोरीवाली	pred_false
born	बोर्न	बॉर्न	pred_false
bolane	बोलने	बोलने	pred_true
boliae	बोलिए	बोलियाई	pred_false
boliy	बोलिए	बोलिय	pred_false
boliye	बोलिए	बोलिय	pred_false
bosaan	बोसान	बोसान	pred_true
bosan	बोसान	बोसन	pred_false
bauni	बौनी	बौनी	pred_true
bouni	बौनी	बौनी	pred_true
byaawa	ब्यावर	ब्यावा	pred_false
byavar	ब्यावर	ब्यवर	pred_false
brajesh	ब्रजेश	ब्रजेश	pred_true
brijesh	ब्रजेश	बृजेश	pred_false
brahmalin	ब्रह्मलीन	ब्रह्मलिन	pred_false
brahmleen	ब्रह्मलीन	ब्रह्मलीन	pred_true
brahmlin	ब्रह्मलीन	ब्रह्मलिन	pred_false
bravo	ब्रावो	ब्रावो	pred_true
brigatn	ब्रिगटन	ब्रिगटन	pred_true
brighton	ब्रिगटन	ब्राइटों	pred_false
brigton	ब्रिगटन	ब्रिगटटन	pred_false
brigadier	ब्रिगेडियर	ब्रिगडी	pred_false
britain	ब्रिटेन	ब्रिटन	pred_false
breed	ब्रीद	ब्रीड	pred_false
brock	ब्रोक	ब्रॉक	pred_false
brok	ब्रोक	ब्रोक	pred_true
broke	ब्रोक	ब्रोक	pred_true
brocken	ब्रोकन	ब्रॉकेन	pred_false
broken	ब्रोकन	ब्रोकेन	pred_false
blosam	ब्लॉसम	ब्लोसमम	pred_false
blossom	ब्लॉसम	ब्लॉसॉम	pred_false
bhagaane	भगाने	भगाने	pred_true
bhagane	भगाने	भगाने	pred_true
bhadakaaya	भड़काया	भड़काया	pred_true
bhadakaya	भड़काया	भड़काया	pred_true
bhadkaayaa	भड़काया	भड़काया	pred_true
bhadkaya	भड़काया	भड़काया	pred_true
bharakaaya	भड़काया	भरकाया	pred_false
bharakaya	भड़काया	भरकाया	pred_false
bhabhoot	भभूत	भभूत	pred_true
bhabhut	भभूत	भाभूत	pred_false
bhay	भय	भय	pred_true
bhaya	भय	भया	pred_false
bhayo	भयो	भयो	pred_true
bharatanatyam	भरतनाट्यम्	भारातना्यम	pred_false
bharatnatyam	भरतनाट्यम्	भारतनात्यम	pred_false
bhartnatyam	भरतनाट्यम्	भार्तनायम	pred_false
bharate	भरते	भरतते	pred_false
bharte	भरते	भर्ते	pred_false
bharani	भरनी	भरणी	pred_false
bharni	भरनी	भरणी	pred_false
bharane	भरने	भरने	pred_true
bharne	भरने	भरने	pred_true
bhara	भरा	भारा	pred_false
bhavishya	भविष्य	भविष्य	pred_true
bhaate	भाते	भाते	pred_true
bhate	भाते	भाटे	pred_false
bhanu	भानू	भानु	pred_false
bhabar	भाबर	भबबर	pred_false
bhareeye	भारीय	भरीय	pred_false
bhariy	भारीय	भारीय	pred_true
bhavanaon	भावनाओं	भावाओं	pred_false
bhavnaon	भावनाओं	भावनाओं	pred_true
bhaskar	भास्कर	भस्कर	pred_false
bheed	भीड़	भीड़	pred_true
bheera	भीरा	भीरा	pred_true
bhira	भीरा	भिरा	pred_false
bheesham	भीष्म	भीशम	pred_false
bhisham	भीष्म	भीषम	pred_false
bhishm	भीष्म	भीष्म	pred_true
bhugat	भुगत	भुगत	pred_true
bhugata	भुगता	भुगता	pred_true
bhugta	भुगता	भुगता	pred_true
bhutto	भुट्टो	भूत्तो	pred_false
bhumi	भुमि	भूमि	pred_false
bhurbhura	भुरभुरा	भूरभूरा	pred_false
bhookh	भूख	भूख	pred_true
bhukh	भूख	भुख	pred_false
bhookhi	भूखी	भूखी	pred_true
bhukhi	भूखी	भूखी	pred_true
bhoogol	भूगोल	भूगोल	pred_true
bhugol	भूगोल	भुगोल	pred_false
bhootal	भूतल	भूतल	pred_true
bhutal	भूतल	भूतल	pred_true
bhoopsingh	भूपसिंह	भूपसिंह	pred_true
bhupsingh	भूपसिंह	भूपसिंह	pred_true
bhumi	भूमी	भूमि	pred_false
bhumika	भूमी	भूमिका	pred_false
bhulata	भूलता	भूलता	pred_true
bhulataa	भूलता	भुलता	pred_false
bhulta	भूलता	भूलता	pred_true
bhula	भूला	भूला	pred_true
bhulaa	भूला	भुला	pred_false
bhooli	भूली	भूली	pred_true
bhuli	भूली	भूलि	pred_false
bhulo	भूलो	भूलो	pred_true
bhulon	भूलों	भूलों	pred_true
bhusi	भूसी	भूसी	pred_true
bhooswaami	भूस्वामी	भूस्वामी	pred_true
bhusvami	भूस्वामी	भूस्वमी	pred_false
bhuswami	भूस्वामी	भूस्वमी	pred_false
bhengapan	भेंगापन	भेंगापन	pred_true
bhairavnath	भैरवनाथ	भैरवनाथ	pred_true
bhairo	भैरो	भैरो	pred_true
bhogatey	भोगते	भोगते	pred_true
bhogte	भोगते	भोगते	pred_true
bhola	भोला	भोला	pred_true
bholi	भोली	भोली	pred_true
bholu	भोलू	भोलू	pred_true
bhaunho	भौंहों	भौनहों	pred_false
bhaunhon	भौंहों	भौनहों	pred_false
bhoonhon	भौंहों	भूनहों	pred_false
bhraant	भ्रांत	भृत	pred_false
bhrant	भ्रांत	भृणत	pred_false
brant	भ्रांत	ब्रंट	pred_false
bhraanti	भ्रांति	भ्रांति	pred_true
bhranti	भ्रांति	भ्रांति	pred_true
branti	भ्रांति	ब्रांटी	pred_false
bhraantiyan	भ्रांतियां	भ्रांतियां	pred_true
bhrantiyan	भ्रांतियां	भ्रातियां	pred_false
bhraantiyon	भ्रांतियों	भ्रांतियों	pred_true
bhrantiyon	भ्रांतियों	भ्रांतियों	pred_true
mangesh	मंगेश	मंगेश	pred_true
manch	मंच	मांच	pred_false
manchit	मंचित	मंचित	pred_true
mancheeye	मंचीय	मंचीय	pred_true
manchiy	मंचीय	मंचीय	pred_true
manchiya	मंचीय	मंचिया	pred_false
manchon	मंचों	मंचों	pred_true
manjil	मंजिल	मंजील	pred_false
manzil	मंजिल	मंजील	pred_false
manjila	मंजिला	मंजीला	pred_false
manzila	मंजिला	मंजीला	pred_false
manjilein	मंजिलें	मंजीलें	pred_false
manjilen	मंजिलें	मंजीलें	pred_false
manzilein	मंजिलें	मंजीलें	pred_false
manto	मंटो	मंतों	pred_false
mantriyon	मंत्रियों	मंत्रियों	pred_true
makrani	मकरानी	मकरानी	pred_true
maksad	मक्सद	मकसद	pred_false
makhdumpur	मखदुमपुर	मखदुमपुर	pred_true
machaaye	मचाए	मछाए	pred_false
machae	मचाए	मचाए	pred_true
machaye	मचाए	मछाए	pred_false
machaanon	मचानों	मशानों	pred_false
machanno	मचानों	मचन्नो	pred_false
machano	मचानों	मचानो	pred_false
machanon	मचानों	मचनों	pred_false
madaura	मढ़ौरा	मदौरा	pred_false
madhuara	मढ़ौरा	मधुरा	pred_false
madhura	मढ़ौरा	मधुरा	pred_false
manipal	मणिपाल	मनिपाल	pred_false
matpatron	मतपत्रों	मत्तत्रों	pred_false
matthe	मत्थे	मट्ठे	pred_false
matsyavatar	मत्स्यावतार	मत्स्यवार	pred_false
matsyavtar	मत्स्यावतार	मतस्यावार	pred_false
masyendranath	मत्स्येंद्रनाथ	मस्यंद्रनाथ	pred_false
matsyendranath	मत्स्येंद्रनाथ	मत्स्यंद्रन	pred_false
madhupur	मधुपुर	मधुपुर	pred_true
manmarji	मनमर्जी	माममर्जी	pred_false
manae	मनाए	मनाई	pred_false
manaye	मनाए	मनाए	pred_true
mnaey	मनाए	मनाई	pred_false
mam	मम	माम	pred_false
mum	मम	मूम	pred_false
maryokar	मयोर्का	मार्यककार	pred_false
mayorka	मयोर्का	मायरका	pred_false
mayorkaa	मयोर्का	मायरका	pred_false
mardaani	मरदानी	मर्दानी	pred_false
mardani	मरदानी	मारदानी	pred_false
marmar	मरमर	मरममर	pred_false
murmur	मरमर	मुरमूर	pred_false
maratha	मराठा	मृता	pred_false
marathi	मराठी	मारथी	pred_false
marji	मर्जी	मार्जी	pred_false
mardanagi	मर्दानगी	मर्दागगी	pred_false
mardangi	मर्दानगी	मरदंगी	pred_false
mardo	मर्दों	मार्डो	pred_false
mardon	मर्दों	मार्डों	pred_false
maryaadaa	मर्यादा	मर्यादा	pred_true
maryada	मर्यादा	मार्याडा	pred_false
maryaadaaon	मर्यादाओं	मर्यादाओं	pred_true
maryadaon	मर्यादाओं	मार्यदाओं	pred_false
malaga	मलागा	मलागा	pred_true
malaar	मलार	मलार	pred_true
malar	मलार	मालर	pred_false
mashrak	मशरक	मश्रक	pred_false
masaaledaar	मसालेदार	मसालेदार	pred_true
masaledaar	मसालेदार	मसलेदार	pred_false
masaledar	मसालेदार	मसलेदार	pred_false
masoor	मसूर	मसूर	pred_true
masur	मसूर	मसूर	pred_true
masse	मस्से	मस्से	pred_true
mahakane	महकने	महकाने	pred_false
mahakne	महकने	महकने	pred_true
mahkane	महकने	महकाने	pred_false
mehkane	महकने	महकाने	pred_false
mahalon	महलों	महालों	pred_false
mahlon	महलों	महलों	pred_true
mahagranth	महाग्रंथ	महाग्रांठ	pred_false
mhagranth	महाग्रंथ	महाग्रां	pred_false
mahajan	महाजन	महाजन	pred_true
mhajan	महाजन	महाजन	pred_true
mahathir	महाथिर	महतिर	pred_false
mhathir	महाथिर	महाथिर	pred_true
mahanatam	महानतम	महानतम	pred_true
mahantam	महानतम	महंतम	pred_false
mhantam	महानतम	महाततम	pred_false
mahanideshak	महानिदेशक	महानिदेशक	pred_true
mahanirdeshak	महानिदेशक	महानिर्देशक	pred_false
mhanideshak	महानिदेशक	महानिदेशक	pred_true
mahapauron	महापौरों	महापारों	pred_false
mhapauron	महापौरों	महापाों	pred_false
mahapran	महाप्राण	महाप्रण	pred_false
mhapran	महाप्राण	महाप्रण	pred_false
mahamantr	महामंत्र	महामंत्र	pred_true
mahamantra	महामंत्र	महामंत्र	pred_true
mhamantra	महामंत्र	महामंत्र	pred_true
maharaja	महाराजा	महराजा	pred_false
mahavigyan	महाविज्ञान	महाविज्ञान	pred_true
mhavidyan	महाविज्ञान	महाविद्यान	pred_false
mahavidya	महाविद्या	महाविद्य	pred_false
mhavidya	महाविद्या	महाविद्य	pred_false
mahavishnu	महाविष्णु	महाविश्नु	pred_false
mahasingh	महासिंह	महासिंह	pred_true
mahasinh	महासिंह	महासिंह	pred_true
mahipal	महिपाल	महिपाल	pred_true
mahin	महीन	महीं	pred_false
mahinon	महीनों	महीनों	pred_true
maang	मांग	मांग	pred_true
mang	मांग	मंग	pred_false
mangani	मांगनी	मंगानी	pred_false
mangni	मांगनी	मंगनी	pred_false
maanga	मांगा	मांगा	pred_true
manga	मांगा	मंगा	pred_false
maangi	मांगी	मांगी	pred_true
mangi	मांगी	मंगी	pred_false
maange	मांगे	मांगे	pred_true
mange	मांगे	मंगे	pred_false
mango	मांगो	मंगों	pred_false
maori	माओरी	मारी	pred_false
maajin	माजिन	माजिन	pred_true
majin	माजिन	मजीन	pred_false
mathe	माथे	माठे	pred_false
mathey	माथे	माे	pred_false
maap	माप	माप	pred_true
map	माप	मैप	pred_false
mop	माप	मोप	pred_false
mamooli	मामूली	ममूली	pred_false
mamuli	मामूली	ममुली	pred_false
mame	मामे	मेम	pred_false
maarvaad	मारवाड़	मारवाद	pred_false
marvad	मारवाड़	मार्वाद	pred_false
marwar	मारवाड़	मारवार	pred_false
maariya	मारिया	मारिया	pred_true
mariya	मारिया	मरिया	pred_false
maariyo	मारियो	मारियो	pred_true
mario	मारियो	मारियो	pred_true
mariyo	मारियो	मारियो	pred_true
martha	मार्था	मार्थ	pred_false
maalish	मालिश	मालिश	pred_true
malish	मालिश	मलीश	pred_false
mave	मावे	मेव	pred_false
mavey	मावे	मवे	pred_false
maas	मास	मास	pred_true
mas	मास	मस	pred_false
mass	मास	मास	pred_true
maason	मासों	मासों	pred_true
mason	मासों	मसों	pred_false
mitaao	मिटाओ	मिटाओ	pred_true
mitao	मिटाओ	मिटाओ	pred_true
mithaai	मिठाई	मिठाई	pred_true
mithai	मिठाई	मिठाई	pred_true
media	मिडिया	मेडिया	pred_false
mithila	मिथिला	मिथिला	pred_true
mithilanchal	मिथिलांचल	मिथिलंचल	pred_false
mithya	मिथ्या	मिथ्य	pred_false
mimicry	मिमिक्री	मिमिक्री	pred_true
milkiyat	मिल्कियत	मिलकियत	pred_false
misha	मिशा	मिशा	pred_true
mungeri	मुंगेरी	मंगरी	pred_false
mundva	मुंडवा	मुंडवा	pred_true
mundwa	मुंडवा	मुंडवा	pred_true
munshiganj	मुंशीगंज	मुंशिगंज	pred_false
mukarte	मुकरते	मुकर्ते	pred_false
mukartey	मुकरते	मुकर्ते	pred_false
mukhopadhyaya	मुखोपाध्याय	मुखोपाध्यय	pred_false
mukhyopadhyaay	मुखोपाध्याय	मुख्योपाध्याय	pred_false
mukhyamantri	मुख्यमंत्री	मुख्यमंत्री	pred_true
munaf	मुनाफ	मूणफ	pred_false
munafa	मुनाफा	मुनझा	pred_false
munnu	मुन्नू	मुन्नु	pred_false
mufalisi	मुफलिसी	मुफलीसी	pred_false
muflisi	मुफलिसी	मुफललसी	pred_false
mubarakpur	मुबारकपुर	मुबराकपुर	pred_false
mubarkpur	मुबारकपुर	मुबर्कपुर	pred_false
murjha	मुर्झा	मूर्झा	pred_false
multae	मुल्ताई	मुलता	pred_false
multai	मुल्ताई	मुलताई	pred_false
mushahid	मुशाहिद	मुशहिद	pred_false
muhavare	मुहावरे	मुहावर	pred_false
muhavre	मुहावरे	मुहावरे	pred_true
mooth	मूठ	मूत	pred_false
muth	मूठ	मूथ	pred_false
mood	मूड	मूड	pred_true
mud	मूड	मुड	pred_false
moodi	मूडी	मूड़ी	pred_false
moody	मूडी	मूद्य	pred_false
mool	मूल	मूल	pred_true
mul	मूल	मूल	pred_true
moolchand	मूलचंद	मूलचंद	pred_true
mulchand	मूलचंद	मूलचंद	pred_true
moolar	मूलर	मूलर	pred_true
mular	मूलर	मुलर	pred_false
muller	मूलर	मललर	pred_false
moolon	मूलों	मूलों	pred_true
mulon	मूलों	मूलों	pred_true
maxico	मेक्सिको	मैक्सिको	pred_false
mexico	मेक्सिको	मैक्सिको	pred_false
mega	मेगा	मेगा	pred_true
megapixal	मेगापिक्सल	मेगापिक्स	pred_false
megapixel	मेगापिक्सल	मेगापिक्स	pred_false
mejbaan	मेजबान	मेजबान	pred_true
mejban	मेजबान	मेजबान	pred_true
mezbaan	मेजबान	मेजबान	pred_true
mejabani	मेजबानी	मेजबानी	pred_true
mejbaani	मेजबानी	मेजबानी	pred_true
mejbani	मेजबानी	मेजबानी	pred_true
mezabani	मेजबानी	मेजबानी	pred_true
mejbaan	मेज़बान	मेजबान	pred_false
mejban	मेज़बान	मेजबान	pred_false
mezbaan	मेज़बान	मेजबान	pred_false
mejbaani	मेज़बानी	मेजबानी	pred_false
mejbani	मेज़बानी	मेजबानी	pred_false
mezbaani	मेज़बानी	मेजबानी	pred_false
mate	मेट	मेट	pred_true
met	मेट	मेट	pred_true
mates	मेट्स	मेट्स	pred_true
medical	मेडीकल	मेडिकल	pred_false
methanol	मेथेनॉल	मेथनॉल	pred_false
menu	मेनू	मेनू	pred_true
mem	मेम	मेम	pred_true
melaghaat	मेलघाट	मेलघाट	pred_true
melghat	मेलघाट	मेलघट	pred_false
melaanin	मेलानिन	मेलानिन	pred_true
melanin	मेलानिन	मेलनिन	pred_false
melaani	मेलानी	मेलानी	pred_true
melani	मेलानी	मेलनी	pred_false
maheman	मेहमान	महेमन	pred_false
mehamaan	मेहमान	मेहमान	pred_true
mehaman	मेहमान	मेहमन	pred_false
mehmaan	मेहमान	मेहमान	pred_true
mehman	मेहमान	मेहमान	pred_true
meharaam	मेहराम	मेहराम	pred_true
mehram	मेहराम	मेहराम	pred_true
macbook	मैकबुक	मकबूक	pred_false
matix	मैट्रिक्स	माटिक्स	pred_false
matrix	मैट्रिक्स	माट्रिक्स	pred_false
mad	मैड	माद	pred_false
made	मैड	मेड	pred_false
maid	मैड	मैद	pred_false
maddy	मैडी	मैडी	pred_true
maidi	मैडी	मैदी	pred_false
main	मैन	मेन	pred_false
man	मैन	मन	pred_false
men	मैन	मेन	pred_false
mainan	मैनन	मैनन	pred_true
menon	मैनन	मेनों	pred_false
manner	मैनर	मैनर	pred_true
maina	मैना	मैना	pred_true
maine	मैने	मैने	pred_true
marrej	मैरेज	मररेज	pred_false
marriage	मैरेज	मैरिज	pred_false
merraige	मैरेज	मररेज	pred_false
maisachusets	मैसाचुसेट्स	मैसाचुसेट्स	pred_true
massachusetts	मैसाचुसेट्स	मैसाचुसेट्स	pred_true
maisor	मैसोर	मैसोर	pred_true
maisore	मैसोर	मैसोर	pred_true
mysore	मैसोर	मिसोर	pred_false
mod	मॉड	मोड़	pred_false
mode	मॉड	मोड़	pred_false
modern	मॉडर्न	मॉडर्न	pred_true
module	मॉड्यूल	मोड़लल	pred_false
modules	मॉड्यूल्स	मोडलल्स	pred_false
modyuls	मॉड्यूल्स	मॉड्युल्स	pred_false
mauritious	मॉरिशस	मोरीशस	pred_false
mauritius	मॉरिशस	मॉरीशस	pred_false
mogali	मोगली	मोगली	pred_true
mowgli	मोगली	मौगली	pred_false
motive	मोटिव	मोटिव	pred_true
mol	मोल	मोल	pred_true
mold	मोल्ड	मोल्ड	pred_true
moshe	मोशे	मोषे	pred_false
mosad	मोसाद	मोसद	pred_false
mohana	मोहाना	मोहना	pred_false
mohani	मोहानी	मोहनी	pred_false
mohini	मोहिनी	मोहिनी	pred_true
mohim	मोहिम	मोहिम	pred_true
maukon	मौकों	मौकों	pred_true
mauma	मौमा	मौमा	pred_true
maurya	मौर्या	मौर्य	pred_false
morya	मौर्या	मोर्या	pred_false
maurya	मौर्यों	मौर्य	pred_false
mauryon	मौर्यों	मौर्यों	pred_true
moryon	मौर्यों	मोर्यों	pred_false
maulaviyon	मौलवियों	मौलवियों	pred_true
maulvidon	मौलवियों	मौलविदों	pred_false
maulviyon	मौलवियों	मौलवियों	pred_true
maule	मौले	मौले	pred_true
mauley	मौले	मौले	pred_true
mausa	मौसा	मौसा	pred_true
yatn	यत्न	यत्न	pred_true
yatna	यत्न	यान्ा	pred_false
yada	यदा	यादा	pred_false
yda	यदा	याडा	pred_false
yaduvansh	यदुवंश	यदुवंश	pred_true
yaduwansh	यदुवंश	यदुवंश	pred_true
jerusalem	यरूशलेम	जेरूसलम	pred_false
yarooshaleim	यरूशलेम	यारुशललिम	pred_false
yarushalem	यरूशलेम	यारुशललम	pred_false
yashpaal	यशपाल	यशपाल	pred_true
yashpal	यशपाल	यशपाल	pred_true
yaatna	यातना	यातना	pred_true
yatna	यातना	यान्ा	pred_false
yaatanaon	यातनाओं	याताओं	pred_false
yatnaon	यातनाओं	यतनाओं	pred_false
yarayan	यात्राएं	यारायण	pred_false
yatraein	यात्राएं	यात्राएं	pred_true
yatraen	यात्राएं	यात्राएं	pred_true
yaariyan	यारियां	यारियां	pred_true
yariyan	यारियां	यारियां	pred_true
yaari	यारी	यारी	pred_true
yari	यारी	यारी	pred_true
yugam	युग्म	युगम	pred_false
yugm	युग्म	यग्म	pred_false
yuddhrat	युद्धरत	युद्धृत	pred_false
yudhrat	युद्धरत	युद्धृत	pred_false
ukrainian	यूक्रेनियन	उक्रेनियां	pred_false
ukranian	यूक्रेनियन	उक्रणियां	pred_false
jerusalem	येरुशलम	जेरूसलम	pred_false
yorker	यॉर्कर	यॉर्कर	pred_true
yojanaein	योजनाएं	योजनाएं	pred_true
yojanaen	योजनाएं	योजनाएं	pred_true
yojanaye	योजनाएं	योजनाय	pred_false
rangate	रंगते	रंगते	pred_true
rangte	रंगते	रंगते	pred_true
rangkata	रंजकता	रंगकता	pred_false
ranjkatha	रंजकता	रांकाठ	pred_false
ranjkta	रंजकता	रणजकता	pred_false
raees	रईस	रैयस	pred_false
rais	रईस	रैस	pred_false
raktaabh	रक्ताभ	रक्तभ	pred_false
raktabh	रक्ताभ	रक्तभ	pred_false
rakhna	रखना	रखना	pred_true
raghupati	रघुपति	रघुपति	pred_true
raghuram	रघुराम	रघुराम	pred_true
registerd	रजिस्टर्ड	रिजिस्ट	pred_false
registered	रजिस्टर्ड	रिजिस्टर	pred_false
ratanpur	रतनपुर	रतनपुर	pred_true
runners	रनर्स	रनर्स	pred_true
rayan	रयान	रायन	pred_false
ryan	रयान	र्यान	pred_false
ralhan	रल्हन	रलहन	pred_false
ravish	रविश	रवीष	pred_false
ravael	रवैल	रवाल	pred_false
ravel	रवैल	रवेल	pred_false
rawail	रवैल	रवैल	pred_true
rasad	रसद	रसा	pred_false
rasaayanik	रसायनिक	रााायिक	pred_false
rasaayanika	रसायनिक	रसायणिक	pred_false
rasayanika	रसायनिक	रसायणिका	pred_false
rasyanik	रसायनिक	राय्यिक	pred_false
rasaayanon	रसायनों	रसायनों	pred_true
rasayanon	रसायनों	रसायनों	pred_true
rahamat	रहमत	रहमत	pred_true
rahmat	रहमत	रहमत	pred_true
rhamat	रहमत	रहमत	pred_true
rahenge	रहेंगे	रहेंगे	pred_true
rahegi	रहेगी	रहेगी	pred_true
rounder	राउंडर	रुंडर	pred_false
raak	राक	राक	pred_true
rak	राक	रक	pred_false
raakhe	राखे	राखे	pred_true
rakhe	राखे	रखे	pred_false
raagon	रागों	रागों	pred_true
ragon	रागों	रागों	pred_true
raghavan	राघवन	रघावण	pred_false
raaj	राज	राज	pred_true
raj	राज	राज	pred_true
rajkot	राजकोट	राजकोत	pred_false
rajtantra	राजतंत्र	राजतंत्र	pred_true
raajneetikaran	राजनीतीकरण	राजनीतिकरण	pred_false
rajneetikaran	राजनीतीकरण	राजनीतकरण	pred_false
rajnitikaran	राजनीतीकरण	राजनीतकरण	pred_false
rajma	राजमां	राजमा	pred_false
rajman	राजमां	राजमान	pred_false
raajasva	राजस्व	राजस्व	pred_true
rajasva	राजस्व	राजस्व	pred_true
raaji	राजी	राजी	pred_true
raji	राजी	राजी	pred_true
rajinaama	राजीनामा	राजनामा	pred_false
rajinama	राजीनामा	राजिनामा	pred_false
raajon	राजों	राजों	pred_true
rajon	राजों	राजों	pred_true
rana	राणा	राना	pred_false
raatrichar	रात्रिचर	रात्रिचार	pred_false
ratrichar	रात्रिचर	रत्रचचार	pred_false
raadhe	राधे	राधे	pred_true
radhe	राधे	राधे	pred_true
ranapur	रानापुर	रणपुर	pred_false
rabin	राबिन	रबीन	pred_false
robin	राबिन	रॉबिन	pred_false
rabha	राभा	रभा	pred_false
ramkot	रामकोट	रामकोट	pred_true
ramkote	रामकोट	रममकोट	pred_false
ramtek	रामटेक	रामतेक	pred_false
rampur	रामपुर	रंमपुर	pred_false
rambharose	रामभरोसे	रामभरोस	pred_false
rambharosey	रामभरोसे	रामभरोसे	pred_true
ramraj	रामराज	रममराज	pred_false
raalod	रालोद	रालोद	pred_true
ralaud	रालोद	राउद्द	pred_false
ralod	रालोद	रालोड	pred_false
ravaley	रावले	रवाले	pred_false
ravle	रावले	रावे	pred_false
rasayanik	रासायनिक	रायानिक	pred_false
racreation	रिक्रिएशन	रैक्रेशन	pred_false
recreation	रिक्रिएशन	रिक्रेशन	pred_false
rig	रिग	रिग	pred_true
riggs	रिग्स	रिग्स	pred_true
rigs	रिग्स	रिग्स	pred_true
richual	रिचुअल	रिचुआल	pred_false
ritual	रिचुअल	रिटुअल	pred_false
reduction	रिडक्शन	रेडक्शन	pred_false
ripan	रिपन	रिपान	pred_false
ripon	रिपन	रिपों	pred_false
ria	रिया	रिया	pred_true
riya	रिया	रिया	pred_true
rishte	रिश्ते	रिश्ते	pred_true
rishtey	रिश्ते	रिष्टे	pred_false
risane	रिसने	रिसने	pred_true
risaney	रिसने	रिसने	pred_true
risne	रिसने	रिसन	pred_false
rihana	रिहाना	रिहाना	pred_true
rihanna	रिहाना	रिहना	pred_false
regal	रीगल	रेगल	pred_false
rigal	रीगल	रिगल	pred_false
reasonal	रीजनल	रिजोनाल	pred_false
regional	रीजनल	रेजियानल	pred_false
retreate	रीट्वीट	रिट्रेट	pred_false
retweet	रीट्वीट	रिटवीट	pred_false
reeta	रीता	रीता	pred_true
rita	रीता	रीता	pred_true
rukate	रुकते	रुकते	pred_true
rukte	रुकते	रुकते	pred_true
ruktey	रुकते	रुकते	pred_true
rugan	रुग्ण	रुगण	pred_false
rugna	रुग्ण	रूग्ण	pred_false
ruganta	रुग्णता	रूगनता	pred_false
rugnata	रुग्णता	रूग्णता	pred_false
rojvelt	रुजवेल्ट	रॉजवेल्ट	pred_false
roojwelt	रुजवेल्ट	रूजवेल्ट	pred_false
roosevelt	रुजवेल्ट	रूजवेल्ट	pred_false
rodolph	रुडोल्फ	रोडोल्फ	pred_false
rudolf	रुडोल्फ	रूडोल्फ	pred_false
rudolph	रुडोल्फ	रुडोल्फ	pred_true
roopesh	रुपेश	रुपेश	pred_true
rupesh	रुपेश	रुपेश	pred_true
ruby	रुबी	रूबी	pred_false
roomani	रुमानी	रूमानी	pred_false
rumani	रुमानी	रूमाणी	pred_false
rukavaton	रूकावटों	रुकावटों	pred_false
root	रूट	रुत	pred_false
route	रूट	रौट	pred_false
rooting	रूटिंग	रूटिंग	pred_true
routine	रूटिंग	राटीन	pred_false
routing	रूटिंग	राटिंग	pred_false
roots	रूट्स	रुट्स	pred_false
routes	रूट्स	राट्स	pred_false
roopak	रूपक	रुपक	pred_false
rupak	रूपक	रुपक	pred_false
roopi	रूपी	रुपी	pred_false
rupi	रूपी	रुपी	pred_false
rantle	रेंटल	रंटल	pred_false
rental	रेंटल	रेंटल	pred_true
registan	रेगिस्तान	रेजिस्टान	pred_false
registani	रेगिस्तानी	रिजिस्तानी	pred_false
reja	रेजा	रेजा	pred_true
reza	रेजा	रेजा	pred_true
rate	रेट	रते	pred_false
rate	रेत	रते	pred_false
ret	रेत	रेट	pred_false
refaeli	रेफेली	रेफेली	pred_true
refeli	रेफेली	रेफली	pred_false
reshe	रेशे	रेश	pred_false
reshey	रेशे	रेशे	pred_true
race	रेस	रेस	pred_true
rese	रेस	रेस	pred_true
racer	रेसर	रेसर	pred_true
recer	रेसर	रीसर	pred_false
racing	रेसिंग	रेसिंग	pred_true
reson	रेसों	रेसन	pred_false
rehaana	रेहाना	रहाना	pred_false
rehana	रेहाना	रहहाना	pred_false
racketeer	रैकेटियर	रककीट	pred_false
racketier	रैकेटियर	रककीट	pred_false
rectare	रैकेटियर	रिक्टर	pred_false
radical	रैडिकल	रेडिकल	pred_false
raidical	रैडिकल	रैडिकल	pred_true
raith	रैथ	रेठ	pred_false
rapping	रैपिंग	रेपिंग	pred_false
wrapping	रैपिंग	व्रापिंग	pred_false
robertsan	रॉबर्टसन	रॉबर्ट्सन	pred_false
robertson	रॉबर्टसन	रॉबर्ट्सन	pred_false
robinson	रॉबिंसन	रॉबिनसों	pred_false
royals	रॉयल्स	रॉयल्स	pred_true
rojlin	रोजलिन	रॉजलिन	pred_false
rozlyn	रोजलिन	रोजलिन	pred_true
rotation	रोटेशन	रोटेशन	pred_true
rodrigo	रोड्रिगो	रोड़गगो	pred_false
ronaldo	रोनाल्डो	रोनालडों	pred_false
ronit	रोनित	रॉनिट	pred_false
roni	रोनी	रोनी	pred_true
ropane	रोपने	रोपने	pred_true
ropaney	रोपने	रोपने	pred_true
ropne	रोपने	रोपने	pred_true
robin	रोबिन	रॉबिन	pred_false
roya	रोया	रोया	pred_true
rollers	रोलर्स	रॉलर्स	pred_false
rovan	रोवन	रोवण	pred_false
rowan	रोवन	रोवाण	pred_false
rosario	रोसारियो	रोसरियो	pred_false
rosariyo	रोसारियो	रोसरियो	pred_false
raubadaar	रौबदार	रौबदार	pred_true
raubadar	रौबदार	रौबदार	pred_true
raubdar	रौबदार	रौबदार	pred_true
landara	लंगड़ा	लंदारा	pred_false
langada	लंगड़ा	लंगड़ा	pred_true
langda	लंगड़ा	लंगगड़ा	pred_false
langar	लंगर	लंगर	pred_true
langaron	लंगरों	लंगारों	pred_false
langron	लंगरों	लंग्रों	pred_false
lambi	लंबी	लंबी	pred_true
lakeer	लकीर	लकीर	pred_true
lakir	लकीर	लककिर	pred_false
lakiron	लकीरों	लकीरों	pred_true
lakme	लक्मे	लकमे	pred_false
lakshmidhar	लक्ष्मीधर	लक्ष्मीदार	pred_false
lakshmighar	लक्ष्मीधर	लक्ष्मीघर	pred_false
lakshy	लक्ष्य	लक्ष्य	pred_true
lakshya	लक्ष्य	लक्ष्य	pred_true
lakshyon	लक्ष्यों	लक्ष्यों	pred_true
lux	लक्स	ल्क	pred_false
laksar	लक्सर	लक्सर	pred_true
luxor	लक्सर	ल्कोर	pred_false
lakhkhi	लख्खी	लखखखी	pred_false
lagna	लगना	लगना	pred_true
laganewale	लगनेवाले	लगनेवाले	pred_true
lagnevaaley	लगनेवाले	लगनेवाले	pred_true
lagnewale	लगनेवाले	लगनेवाले	pred_true
lagega	लगेगा	लगेगा	pred_true
lajjalu	लज्जालु	लज्जालु	pred_true
latkate	लटकाते	लटकते	pred_false
ladki	लड़की	लड़की	pred_true
ladate	लड़ते	लड़ते	pred_true
ladte	लड़ते	लड़ते	pred_true
ladaai	लड़ाई	लदाई	pred_false
ladai	लड़ाई	लड़ाई	pred_true
ladaaiyon	लड़ाईयों	लड़ाइयों	pred_false
ladaeyon	लड़ाईयों	लड़ाइयों	pred_false
ladaiyon	लड़ाईयों	लड़ाइयों	pred_false
lapetane	लपेटने	लापटाने	pred_false
lapetne	लपेटने	लापटेन	pred_false
labada	लबादा	लबड़ा	pred_false
lbada	लबादा	लबड़ा	pred_false
labdh	लब्ध	लब्ध	pred_true
lbdh	लब्ध	ल्ब्ध	pred_false
lalak	ललक	लालक	pred_false
lalkarata	ललकारता	लाकराता	pred_false
lalkarta	ललकारता	लाकर्ता	pred_false
lalla	लल्ला	लाल्ला	pred_false
lavasa	लवासा	लवासा	pred_true
lovasa	लवासा	लवासा	pred_true
lassi	लस्सी	लासी	pred_false
lahanaa	लहना	लहना	pred_true
lahna	लहना	लहना	pred_true
lehna	लहना	लहना	pred_true
lahraee	लहराई	लहराई	pred_true
lahrai	लहराई	लहराई	pred_true
lehrayi	लहराई	लहरायी	pred_false
lahalhati	लहलहाती	लहलहटी	pred_false
lahlahaati	लहलहाती	लहलहााती	pred_false
lahlahati	लहलहाती	लहलहटी	pred_false
lahsun	लहसुन	लहसून	pred_false
lasoon	लहसुन	लासून	pred_false
lanchar	लांचर	लांचार	pred_false
launcher	लांचर	लॉंचर	pred_false
lycopene	लाइकोपिन	लिकॉपेन	pred_false
lime	लाइम	लाइम	pred_true
lives	लाइव्स	लिव्स	pred_false
live	लाईव	लाइव	pred_false
laegi	लाएगी	लागी	pred_false
lagataar	लागातार	लगतााार	pred_false
lagatar	लागातार	लगातार	pred_false
laata	लाता	लाता	pred_true
lata	लाता	लटा	pred_false
laati	लाती	लाती	pred_true
lati	लाती	लती	pred_false
layega	लायेगा	लाएगा	pred_false
lalpur	लालपुर	लालपुर	pred_true
las	लास्ट	लास	pred_false
last	लास्ट	लास्त	pred_false
lindbhed	लिंगभेद	लिंद्ेेड	pred_false
lingbhed	लिंगभेद	लिंगबेड	pred_false
lindan	लिंडन	लिंडन	pred_true
lindn	लिंडन	लिंडन	pred_true
lindon	लिंडन	लिंडों	pred_false
likhakar	लिखकर	लिखाकर	pred_false
likhkar	लिखकर	लिखकर	pred_true
ligar	लिगर	लिगार	pred_false
liger	लिगर	लाइजर	pred_false
liberation	लिबरेशन	लिब्रेटन	pred_false
libration	लिबरेशन	लाइब्रेशन	pred_false
liberation	लिब्रेशन	लिब्रेटन	pred_false
libration	लिब्रेशन	लाइब्रेशन	pred_false
leaderon	लीडरों	लीडरों	pred_true
leedaron	लीडरों	लीदारों	pred_false
lidaron	लीडरों	लिदारों	pred_false
liidaron	लीडरों	लिदारों	pred_false
louis	लुईस	लाउस	pred_false
luis	लुईस	लुस	pred_false
ludhakate	लुढ़कते	लुढ़कते	pred_true
ludhkate	लुढ़कते	लुढ़कते	pred_true
lurhakate	लुढ़कते	लुढ़कते	pred_true
lutf	लुत्फ	लूट	pred_false
lumding	लुमडिंग	लमडिंग	pred_false
lootmaar	लूटमार	लुटमार	pred_false
lootmar	लूटमार	लुटमार	pred_false
landal	लेंडल	लंदल	pred_false
lendal	लेंडल	लेंडल	pred_true
lega	लेगा	लेगा	pred_true
legaa	लेगा	लेगा	pred_true
letakar	लेटकर	लेटकर	pred_true
letkar	लेटकर	लीटकर	pred_false
lenevali	लेनेवाली	लेनेवाली	pred_true
lenewali	लेनेवाली	लेनेवाली	pred_true
label	लेबल	लेबेल	pred_false
labeling	लेबलिंग	लेबेलिंग	pred_false
labelling	लेबलिंग	लेबेलिंग	pred_false
labelo	लेबलों	लबेलो	pred_false
labelon	लेबलों	लबेलों	pred_false
lebalon	लेबलों	लेबलों	pred_true
lemon	लेमन	लेमोन	pred_false
laingadan	लैंगडन	लांगड़ान	pred_false
langdon	लैंगडन	लंगडडों	pred_false
lengdan	लैंगडन	लेंगड्न	pred_false
laigikata	लैंगिकता	लागिकता	pred_false
laingikta	लैंगिकता	लांगिकता	pred_false
lanset	लैंसेट	लैंसेट	pred_true
lenset	लैंसेट	लेंसेट	pred_false
lairi	लैरी	लैरी	pred_true
lairy	लैरी	लेरी	pred_false
larry	लैरी	लारी	pred_false
lace	लैस	लेस	pred_false
less	लैस	लेस	pred_false
locket	लॉकेट	लॉकेट	pred_true
laundry	लॉन्ड्री	लॉनद्री	pred_false
longewal	लोंगोवाल	लोंगेवाल	pred_false
longewala	लोंगोवाल	लोंगेवाला	pred_false
longoval	लोंगोवाल	लोंगोवाल	pred_true
log	लोग	लॉग	pred_false
loge	लोगे	लॉज	pred_false
lochdar	लोचदार	लोचदार	pred_true
lodi	लोदी	लोडी	pred_false
laurence	लौरेंस	लारेंस	pred_false
laurens	लौरेंस	लारेंस	pred_false
laurense	लौरेंस	लारेंस	pred_false
wonder	वंडर	वांडर	pred_false
vansh	वंश	वांश	pred_false
vanshdhar	वंशधर	वंशधार	pred_false
vanshavad	वंशवाद	वाषावाद	pred_false
vanshvaad	वंशवाद	वाष्वाद	pred_false
vanshvad	वंशवाद	वाष्वाद	pred_false
wanshwad	वंशवाद	वाश्वद	pred_false
vajood	वजूद	वाजुद	pred_false
vajud	वजूद	वाजुद	pred_false
wajood	वजूद	वाजुद	pred_false
vadali	वडाली	वदली	pred_false
vadli	वडाली	वदली	pred_false
wadali	वडाली	वदली	pred_false
vanita	वनिता	वाणिता	pred_false
vareinye	वरेण्य	वरीन्य	pred_false
varenya	वरेण्य	वरेण्य	pred_true
varn	वर्ण	वर्ण	pred_true
varna	वर्ण	वर्ण	pred_true
varnit	वर्णित	वरणीत	pred_false
vartamaan	वर्तमान	वर्तमान	pred_true
vartaman	वर्तमान	वर्तमान	pred_true
vartmaan	वर्तमान	वर्तमान	pred_true
vartman	वर्तमान	वार्तमान	pred_false
varddhaman	वर्द्धमान	वर्द्धमान	pred_true
vardhmaan	वर्द्धमान	वर्धमान	pred_false
vardhman	वर्द्धमान	वर्धमान	pred_false
verbal	वर्बल	वर्बल	pred_true
varshan	वर्शन	वर्षण	pred_false
vasharan	वर्शन	वशारण	pred_false
vershan	वर्शन	वर्षण	pred_false
version	वर्शन	वर्शन	pred_true
varsaache	वर्साचे	वर्साचे	pred_true
varsaryache	वर्साचे	वर्सराच	pred_false
vasearche	वर्साचे	वसीर्चे	pred_false
valkan	वल्कन	वल्कन	pred_true
valkkan	वल्कन	वलक्कन	pred_false
velkan	वल्कन	वेलकन	pred_false
vash	वश	वाश	pred_false
vashikaran	वशीकरण	वाषीकरण	pred_false
vaangchuk	वांगचुक	वागचुक	pred_false
vangchuk	वांगचुक	वंगचुक	pred_false
wangchuk	वांगचुक	वंगचुक	pred_false
want	वांट	वंत	pred_false
vije	वाइज	विजे	pred_false
vise	वाइज	विज	pred_false
wise	वाइज	वाइज	pred_true
vatar	वाटर	वातर	pred_false
water	वाटर	वेटर	pred_false
watson	वाटसन	वास्टन	pred_false
wattson	वाटसन	वैट्सन	pred_false
vaan	वाण	वान	pred_false
waan	वाण	वान	pred_false
vaanon	वाणों	वाणों	pred_true
vanon	वाणों	वाणों	pred_true
wanon	वाणों	वानों	pred_false
vatanukulan	वातानुकूलन	वतानुकूलन	pred_false
watanukoollan	वातानुकूलन	वतानुकूल	pred_false
vaadak	वादक	वादक	pred_true
vadak	वादक	वादक	pred_true
vaadiyon	वादियों	वादियों	pred_true
vadiyon	वादियों	वादियों	pred_true
wadiyon	वादियों	वाडियों	pred_false
vayana	वायना	वायना	pred_true
vayna	वायना	वायना	pred_true
wayna	वायना	वायना	pred_true
wireless	वायरलेस	वायरेस	pred_false
wirerless	वायरलेस	वायरलेस	pred_true
warrior	वारियर्स	वारियर	pred_false
warriors	वारियर्स	वारियर्स	pred_true
valve	वाल्व	वाल्व	pred_true
wolv	वाल्व	वल्व	pred_false
vastavik	वास्तविक	वास्तविक	pred_true
vastvik	वास्तविक	वास्तिक	pred_false
vaahikayen	वाहिकाएं	वाहिकाएं	pred_true
vahikayen	वाहिकाएं	वाहिकाएं	pred_true
wahikayan	वाहिकाएं	वाहिकायां	pred_false
winter	विंटर	विंटर	pred_true
vincent	विंसेंट	विंसेंट	pred_true
vikalpon	विकल्पों	विकल्पों	pred_true
wicket	विकेट	विकट	pred_false
vikramjeet	विक्रमजीत	विक्रमीत	pred_false
vikramjit	विक्रमजीत	विक्रमजित	pred_false
vichaarakon	विचारकों	विचारकों	pred_true
vicharakon	विचारकों	विचारकों	pred_true
vigyan	विज्ञान	विज्ञान	pred_true
vigyaani	विज्ञानी	विज्ञानी	pred_true
vigyani	विज्ञानी	विज्ञानी	pred_true
vigyaanon	विज्ञानों	विज्ञानों	pred_true
vigyanon	विज्ञानों	विज्ञानों	pred_true
vitthal	विट्ठल	वित्थल	pred_false
viththal	विठ्ठल	विथाल	pred_false
vitthal	विठ्ठल	वित्थल	pred_false
vitark	वितर्क	विटार्क	pred_false
vidhaaein	विद्याएं	विधाएं	pred_false
vidyaayein	विद्याएं	विद्याई	pred_false
vidyaen	विद्याएं	विद्यान	pred_false
vidhaaon	विद्याओं	विधाओं	pred_false
vidyaaon	विद्याओं	विद्याओं	pred_true
vidyaon	विद्याओं	विद्याओं	pred_true
vidhansabhaein	विधानसभाएं	विदानसभाएं	pred_false
vidhansabhaen	विधानसभाएं	विदानसभाएं	pred_false
vidhivat	विधिवत	विद्वित	pred_false
vidhut	विधुत	विद्युत	pred_false
vinasht	विनष्ट	विनाश्ट	pred_false
vineet	विनीत	विनीत	pred_true
vinit	विनीत	विनित	pred_false
vipreetataa	विपरीतता	विप्रीतता	pred_false
vipritata	विपरीतता	विप्रता	pred_false
vipra	विप्रा	विप्र	pred_false
vipro	विप्रो	विप्रो	pred_true
wipro	विप्रो	विप्रो	pred_true
vibha	विभा	विभा	pred_true
vibhajak	विभाजक	विभाजक	pred_true
vibhram	विभ्रम	विभ्रम	pred_true
vibhrm	विभ्रम	विभर्म	pred_false
vibram	विभ्रम	विब्राम	pred_false
vimarsh	विमर्श	विमार्श	pred_false
vimarsho	विमर्शों	विमार्शो	pred_false
vimarshon	विमर्शों	विमर्षों	pred_false
virajati	विराजती	विराजति	pred_false
virechan	विरेचन	विरेचन	pred_true
virodh	विरोध	विरोध	pred_true
virodhabhasi	विरोधाभासी	विरोधाभासी	pred_true
virodhabhason	विरोधाभासों	विरोधाभों	pred_false
vividh	विविध	विविध	pred_true
vivekahin	विवेकहीन	विवेकहीन	pred_true
vivekheen	विवेकहीन	विवखीन	pred_false
visheshan	विशेषण	विशेषण	pred_true
visheshanon	विशेषणों	विशेषणों	pred_true
visheshaadhikaar	विशेषाधिकार	विशेषाधिकार	pred_true
visheshadhikar	विशेषाधिकार	विशेषाधिकार	pred_true
vishwasaniy	विश्वसनीय	विश्वानीय	pred_false
vishwasniiya	विश्वसनीय	विश्वसीनय	pred_false
vishwasaniyata	विश्वसनीयता	विश्वासनीयता	pred_false
vishwasniiyataa	विश्वसनीयता	विश्वस्नियता	pred_false
vishahin	विषहीन	विशहीन	pred_false
vishhin	विषहीन	विश्न	pred_false
vishanu	विष्णु	विषाणु	pred_false
vishnu	विष्णु	विष्णु	pred_true
vlc	वीएलसी	वीलीसी	pred_false
weeks	वीक्स	विक्स	pred_false
veerchand	वीरचंद	वीरचंद	pred_true
virchand	वीरचंद	विरचचंद	pred_false
veeresh	वीरेश	वीरेश	pred_true
viresh	वीरेश	विरेश	pred_false
vritton	वृत्तों	वृत्तों	pred_true
vruton	वृत्तों	वृतों	pred_false
vrutton	वृत्तों	वृत्तों	pred_true
venkataraman	वेंकटरमन	वेंकटरमण	pred_false
venkatraman	वेंकटरमन	वेंकटरमण	pred_false
ved	वेड	वेद	pred_false
wade	वेड	वेड	pred_true
wed	वेड	वेद	pred_false
wedding	वेडिंग	वेडिंग	pred_true
vediyon	वेदियों	वेडियों	pred_false
vedon	वेदों	वेदों	pred_true
venezuela	वेनेजुएला	वेनेजूला	pred_false
veronica	वेरोनिका	वरोनिका	pred_false
veronika	वेरोनिका	वरोणिका	pred_false
weronika	वेरोनिका	वरोणिका	pred_false
velvet	वेलवेट	वेलवेट	pred_true
welwet	वेलवेट	वेलवेट	pred_true
welder	वेल्डर	वेल्डर	pred_true
weldor	वेल्डर	वेल्डोर	pred_false
welding	वेल्डिंग	वेल्डिंग	pred_true
wealth	वेल्थ	वेल्थ	pred_true
vellur	वेल्लूर	वेलर	pred_false
velur	वेल्लूर	वेल्यर	pred_false
vesh	वेश	वेश	pred_true
wasting	वेस्टिंग	वास्टिंग	pred_false
westing	वेस्टिंग	वेस्टिंग	pred_true
wastinghouse	वेस्टिंगहाउस	वास्टिंहाउस	pred_false
westinghouse	वेस्टिंगहाउस	वेस्टिंचास	pred_false
vaisley	वेस्ले	वैसले	pred_false
vesle	वेस्ले	वेसल	pred_false
wesle	वेस्ले	वेसल	pred_false
vaigyaanik	वैज्ञानिक	वैज्ञािक	pred_false
vaigyanik	वैज्ञानिक	वैज्ञािक	pred_false
vegyanik	वैज्ञानिक	वैज्ञािक	pred_false
vaigyaanikta	वैज्ञानिकता	वैज्ञानिकता	pred_true
vaigyanikata	वैज्ञानिकता	वैज्ञानिकता	pred_true
vaigyanikta	वैज्ञानिकता	वैज्ञानिकता	pred_true
vaitravati	वैत्रवती	वैत्रवति	pred_false
vaitrawati	वैत्रवती	वैत्रवति	pred_false
vaimanasy	वैमनस्य	वैमानस्य	pred_false
vaimanasya	वैमनस्य	वैमानस्य	pred_false
vaimanya	वैमनस्य	वैमान्य	pred_false
very	वैरी	वेरी	pred_false
vaisaakh	वैशाख	वैसाख	pred_false
vaishakh	वैशाख	वैशाख	pred_true
vaishaakhi	वैशाखी	वैशाखी	pred_true
vaishakhi	वैशाखी	वैशाखी	pred_true
vaishnodevi	वैष्णोदेवी	वैशनोदेवी	pred_false
vyaktigat	व्यक्तिगत	व्यक्तिगत	pred_true
vyagr	व्यग्र	व्याग्र	pred_false
vyagra	व्यग्र	व्याग्र	pred_false
vyatit	व्यतीत	व्यतित	pred_false
vytit	व्यतीत	व्यतित	pred_false
vyabhichar	व्यभिचार	व्यभिचार	pred_true
vyabhichari	व्यभिचार	व्यभिचारी	pred_false
vyavadhan	व्यवधान	व्यवधान	pred_true
vyavdhan	व्यवधान	व्यवधान	pred_true
vyavahargat	व्यवहारगत	व्यवहारगत	pred_true
vyvhargat	व्यवहारगत	व्वहहर्गत	pred_false
vyaghat	व्याघात	व्यघात	pred_false
vyapak	व्यापक	व्यापक	pred_true
vlad	व्लाद	व्लाद	pred_true
wlaad	व्लाद	व्लाद	pred_true
vladimir	व्लादिमीर	व्लादिमीर	pred_true
shanghai	शंघाई	शंघाई	pred_true
shatpath	शतपथ	शतपा	pred_false
shanivar	शनिवार	शानीवार	pred_false
shaniwar	शनिवार	शानीवार	pred_false
shabana	शबाना	शबाना	pred_true
shbana	शबाना	शबाना	pred_true
shabdarth	शब्दार्थ	शब्दार्थ	pred_true
shamadan	शमादान	शमदान	pred_false
shmadan	शमादान	शमदान	pred_false
shamitabh	शमिताभ	शमीताभ	pred_false
shamil	शमिल	शमील	pred_false
shmil	शमिल	शमील	pred_false
sharabon	शराबों	शराबों	pred_true
shrabon	शराबों	श्रबों	pred_false
shararat	शरारत	शररात	pred_false
shrart	शरारत	श्रार्त	pred_false
sharmana	शर्माना	शर्मण	pred_false
shaharwasiyon	शहरवासियों	शहर्वसियों	pred_false
shahrvasiyon	शहरवासियों	शहर्वासियों	pred_false
shervasiyon	शहरवासियों	शर्वासियों	pred_false
shahdara	शहादरा	शाहदारा	pred_false
shaantikaal	शांतिकाल	शांतिकाल	pred_true
shantikal	शांतिकाल	शांतिकाल	pred_true
shaao	शाओ	शाओ	pred_true
shao	शाओ	शा	pred_false
shaakir	शाकिर	शाकीर	pred_false
shakir	शाकिर	शाकीर	pred_false
shaakhaaen	शाखाएं	शाखाएं	pred_true
shakhayan	शाखाएं	शखायां	pred_false
shakhayen	शाखाएं	शखाएं	pred_false
shayak	शायक	शयाक	pred_false
shaavakon	शावकों	शावकों	pred_true
shavakon	शावकों	शवाकों	pred_false
shavkon	शावकों	शवकों	pred_false
shaasaka	शासक	शासका	pred_false
shasak	शासक	शासक	pred_true
sasakon	शासकों	ससकों	pred_false
shaasakon	शासकों	शासकों	pred_true
shasakon	शासकों	शासकों	pred_true
shipra	शिप्रा	शिप्र	pred_false
shirke	शिर्के	शिरके	pred_false
sheershakon	शीर्षकों	शीर्षकों	pred_true
shirshakon	शीर्षकों	शिर्षकों	pred_false
shirshkon	शीर्षकों	शिर्षकों	pred_false
shujaat	शुजात	शुजात	pred_true
shujat	शुजात	शुजात	pred_true
shooting	शुटिंग	शूटिंग	pred_false
shutting	शुटिंग	शट्टिंग	pred_false
should	शुड	शुल्ड	pred_false
shud	शुड	शुद	pred_false
shubhankar	शुभंकर	शुभंकार	pred_false
shumaali	शुमाली	शुमाली	pred_true
shumali	शुमाली	शुमाली	pred_true
shringaar	शृंगार	श्रृंगार	pred_false
shringar	शृंगार	श्रृंगार	pred_false
shrungar	शृंगार	शृंगर	pred_false
sheling	शेलिंग	शेलिंग	pred_true
shelling	शेलिंग	शेलिंग	pred_true
shaili	शैली	शैली	pred_true
shaly	शैली	शल्य	pred_false
sheli	शैली	शेली	pred_false
shaishav	शैशव	शैशव	pred_true
sean	शॉन	सीन	pred_false
shaun	शॉन	शौन	pred_false
shawn	शॉन	शान	pred_false
short	शोर्ट	शोर्ट	pred_true
sure	श्योर	सुरे	pred_false
shrankhala	श्रंखला	श्रृंखला	pred_false
shrankhalaa	श्रंखला	श्रृंखला	pred_false
shrunkhla	श्रंखला	शृंखला	pred_false
shrankhalaaon	श्रंखलाओं	शृंखलाओं	pred_false
shrinkhalaon	श्रंखलाओं	शृंखलाओं	pred_false
shrunkhlaon	श्रंखलाओं	शृंखलाओं	pred_false
shravani	श्रावणी	श्रवाणी	pred_false
shrikar	श्रीकर	श्रीकार	pred_false
shrikhand	श्रीखंड	श्रृखंद	pred_false
shrimati	श्रीमति	श्रीमति	pred_true
shriram	श्रीराम	श्रीरम	pred_false
sriram	श्रीराम	स्रीरम	pred_false
shrotaon	श्रोताओं	श्रोताओं	pred_true
shat	षट्	शत	pred_false
sankhyaein	संख्याएं	संख्याएं	pred_true
sankhyaen	संख्याएं	संख्याएं	pred_true
sankhyayen	संख्याएं	संख्याएं	pred_true
sanghanit	संघनित	संघानित	pred_false
sanghnit	संघनित	संघनित	pred_true
sanchayan	संचयन	संचाया	pred_false
sanchar	संचार	संचार	pred_true
sanchaari	संचारी	संचारी	pred_true
sanchari	संचारी	संचारी	pred_true
sanchalanon	संचालनों	संचानों	pred_false
sanchalnon	संचालनों	संचलनों	pred_false
sanjay	संजय	संजय	pred_true
sanjeevan	संजीवन	संजीवन	pred_true
sanjivan	संजीवन	संजीवन	pred_true
santati	संतति	संताती	pred_false
sandarbh	संदर्भ	संदर्भ	pred_true
sandarbha	संदर्भ	संदर्भ	pred_true
sandrbh	संदर्भ	संद्रभ	pred_false
sandarbhon	संदर्भों	संदर्भों	pred_true
sandrbhon	संदर्भों	संद्रभों	pred_false
sandali	संदली	संडली	pred_false
sandli	संदली	संडली	pred_false
sandhan	संधान	संधन	pred_false
samprati	संप्रति	संप्रति	pred_true
samprti	संप्रति	संप्रति	pred_true
samprabhu	संप्रभु	संप्रभु	pred_true
samprbhu	संप्रभु	संप्रभु	pred_true
samprabhuta	संप्रभुता	संप्रभूता	pred_false
samprbhuta	संप्रभुता	संप्रभूता	pred_false
sambit	संबित	संबित	pred_true
sambhalane	संभालने	संभाने	pred_false
sambhalne	संभालने	संभाने	pred_false
sambhrant	संभ्रांत	संभृत	pred_false
sanbharnt	संभ्रांत	संभारणत	pred_false
sanyog	संयुक्त	संयोग	pred_false
sanyukt	संयुक्त	संयुक्त	pred_true
sanyukta	संयुक्त	संयुक्त	pred_true
sanyukta	संयुक्ता	संयुक्त	pred_false
sanyogvash	संयोगवश	संयोग्वश	pred_false
sanyojan	संयोजन	संयोजन	pred_true
sanyojanon	संयोजनों	संयोजनों	pred_true
sanyojnon	संयोजनों	संयोजनों	pred_true
samvedikaran	संवेदीकरण	संवेदीकरण	pred_true
sanvedikaran	संवेदीकरण	संवेदीकरण	pred_true
samshayon	संशयों	समशायों	pred_false
sanshayon	संशयों	संशयों	pred_true
sanshyon	संशयों	संश्यों	pred_false
sanskaar	संस्कार	संस्कार	pred_true
sanskar	संस्कार	संसकार	pred_false
sanskaari	संस्कारी	संसकारी	pred_false
sanskari	संस्कारी	संसकरी	pred_false
sanskrit	संस्कृत	संस्कृत	pred_true
sanskurt	संस्कृत	संस्कृत	pred_true
sanskritiyan	संस्कृतियां	संस्तितां	pred_false
sanskrutiyan	संस्कृतियां	संस्कृतियां	pred_true
sanskritiyon	संस्कृतियों	संस्तितियों	pred_false
sanskrutiyon	संस्कृतियों	संस्कृतियों	pred_true
sanasthit	संस्थित	सनस्थित	pred_false
sansthit	संस्थित	संस्थित	pred_true
sanasthita	संस्थिता	संस्थिता	pred_true
sansthita	संस्थिता	संस्थिता	pred_true
sakara	सकरा	सकारा	pred_false
sakra	सकरा	सक्र	pred_false
sakshan	सक्शन	सक्षण	pred_false
suction	सक्शन	सक्शन	pred_true
sacchidanand	सच्चिदानंद	सच्चिदान	pred_false
sachhidanand	सच्चिदानंद	सच्चिदान	pred_false
sachidanand	सच्चिदानंद	सचीदानंद	pred_false
sajja	सज्जा	सज्जा	pred_true
sat	सत	सत	pred_true
satpal	सतपाल	सत्ताल	pred_false
satluj	सतलुज	सतलूज	pred_false
sataane	सताने	सताने	pred_true
satane	सताने	सताने	pred_true
sate	सते	सते	pred_true
satti	सत्ती	सत्ती	pred_true
satvat	सत्वत	सत्वत	pred_true
sadanand	सदानंद	सदानद	pred_false
sapane	सपने	सपाने	pred_false
sapne	सपने	सपने	pred_true
sapney	सपने	सपने	pred_true
saparivaar	सपरिवार	सपरिवार	pred_true
sapariwar	सपरिवार	सपरिवार	pred_true
sparivar	सपरिवार	स्परिवार	pred_false
sapaat	सपाट	सपात	pred_false
sapat	सपाट	सपत	pred_false
sapate	सपाटे	सपते	pred_false
sapatey	सपाटे	सपते	pred_false
saptakranti	सप्तक्रांति	सप्तक्रंति	pred_false
saptkraanti	सप्तक्रांति	सप्तकांति	pred_false
saptapadi	सप्तपदी	सप्तापी	pred_false
saptpadi	सप्तपदी	सप्तपादी	pred_false
saptari	सप्तरी	सप्तरी	pred_true
sapramaan	सप्रमाण	सप्रमाण	pred_true
sapraman	सप्रमाण	सप्रमण	pred_false
submit	सबमिट	सबमित	pred_false
sabmission	सबमिशन	सब्मिशन	pred_false
submission	सबमिशन	सबमीशन	pred_false
sabhaein	सभाएं	सभाईं	pred_false
sabhaen	सभाएं	सभाएं	pred_true
sabhayen	सभाएं	सभाएं	pred_true
sabhen	सभाएं	सभेन	pred_false
sabhasadon	सभासदों	सभासदों	pred_true
sabhyata	सभ्यता	सभ्यता	pred_true
samjhoonga	समझूंगा	संझूंगा	pred_false
samjhunga	समझूंगा	समझुंगा	pred_false
samjhungaa	समझूंगा	समझुगा	pred_false
saman	समन	समन	pred_true
samanvayaka	समन्वयक	समन्वयाका	pred_false
samanwayaka	समन्वयक	समन्वयाका	pred_false
samnvyak	समन्वयक	समन्वाक	pred_false
samaadhaan	समाधान	समाधान	pred_true
samadhan	समाधान	समधन	pred_false
samadhiyon	समाधियों	समाधियों	pred_true
samadjiyon	समाधियों	समद्जियों	pred_false
samalakha	समालखा	समलखा	pred_false
samalakhaa	समालखा	समलखा	pred_false
samahaar	समाहार	समहार	pred_false
samahar	समाहार	समहहार	pred_false
samitiyan	समितियां	समीतियां	pred_false
sametati	समेटती	समेटती	pred_true
sametti	समेटती	समेटी	pred_false
sarka	सरका	सर्का	pred_false
sarkaa	सरका	सरका	pred_true
sarkarein	सरकारें	सर्कें	pred_false
sarkaren	सरकारें	सर्करें	pred_false
sarkaaron	सरकारों	सरकारों	pred_true
sarkaron	सरकारों	सर्करों	pred_false
sargana	सरगना	सर्गण	pred_false
sarganaon	सरगनाओं	सर्गणाओं	pred_false
sargi	सरगी	सर्गी	pred_false
sarguja	सरगुजा	सरगुजा	pred_true
sarjuga	सरगुजा	सर्जगा	pred_false
sarsa	सरसा	सरसा	pred_true
sarsaa	सरसा	सरसा	pred_true
sarahind	सरहिंद	साहहंद	pred_false
sarhind	सरहिंद	साहिंद	pred_false
sirhind	सरहिंद	सिरहंद	pred_false
saraaha	सराहा	सराह	pred_false
saraha	सराहा	सरहा	pred_false
saraahi	सराही	सारही	pred_false
sarahi	सराही	साहाही	pred_false
salaahkar	सलाहकार	सलाहकर	pred_false
salahkaar	सलाहकार	सलाहकार	pred_true
salahkar	सलाहकार	सलाहकर	pred_false
saleeb	सलीब	सलीब	pred_true
salib	सलीब	सालिब	pred_false
select	सलेक्ट	सेलेक्ट	pred_false
saltanat	सल्तनत	सल्टानत	pred_false
saltnat	सल्तनत	सल्टना	pred_false
savaal	सवाल	सवाल	pred_true
saval	सवाल	सावल	pred_false
sawaal	सवाल	सवाल	pred_true
sawal	सवाल	सवाल	pred_true
sahakalaakar	सहकलाकार	सहकलाकर	pred_false
sahakalakar	सहकलाकार	सहकालकर	pred_false
sahkalakar	सहकलाकार	सहकाकार	pred_false
sahadev	सहदेव	सहदेव	pred_true
sahdev	सहदेव	सहदेव	pred_true
sahrawat	सहरावत	सहरावत	pred_true
sherawat	सहरावत	शेरावत	pred_false
sahooliyata	सहूलियत	सहूलियता	pred_false
sahuliyat	सहूलियत	सहुलियत	pred_false
sahuuliyata	सहूलियत	सहुलीयता	pred_false
saanketika	सांकेतिक	सांकटिका	pred_false
sanketik	सांकेतिक	संकटिक	pred_false
saimans	साइमंस	सैमांस	pred_false
simmons	साइमंस	सिमंस	pred_false
symons	साइमंस	सीम्स	pred_false
saima	साइमा	सैमा	pred_false
sagarika	सागरिका	सागारिका	pred_false
sagrika	सागरिका	सग्रिका	pred_false
saga	सागा	सागा	pred_true
saajan	साजन	साजन	pred_true
sajan	साजन	सजन	pred_false
saajsajja	साजसज्जा	साजसज्ज	pred_false
sajsajja	साजसज्जा	सजसजज	pred_false
saja	साजा	सजा	pred_false
saathsaath	साथसाथ	साठसाथ	pred_false
sathsath	साथसाथ	सथसथथ	pred_false
sathiya	साथिया	साठिया	pred_false
saabah	साबाह	साबहह	pred_false
sabah	साबाह	सबाह	pred_false
samanjasy	सामंजस्य	समंजस्य	pred_false
samanjasya	सामंजस्य	समंजस्य	pred_false
samoa	सामोआ	समो	pred_false
samoaa	सामोआ	समोऊ	pred_false
saayn	सायं	सायन	pred_false
sayan	सायं	सायन	pred_false
saym	सायं	सायम	pred_false
saira	सायरा	सैरा	pred_false
sayara	सायरा	सायरा	pred_true
sayra	सायरा	सायरा	pred_true
salve	साल्वे	सालवे	pred_false
sahab	साहब	सहब	pred_false
singapore	सिंगापुर	सिंगापोर	pred_false
singaar	सिंगार	सिंगार	pred_true
singar	सिंगार	सिंगर	pred_false
singer	सिंगार	सिंगर	pred_false
singhaadey	सिंघाड़े	सिंहाड़े	pred_false
singhade	सिंघाड़े	सिंहाड़े	pred_false
singhde	सिंघाड़े	सिंहडडे	pred_false
singhre	सिंघाड़े	सिंहरे	pred_false
singhi	सिंघी	सिंही	pred_false
singha	सिंहा	सिंहा	pred_true
sinha	सिंहा	सिन्हा	pred_false
siera	सिएरा	सिरा	pred_false
sierra	सिएरा	सिररा	pred_false
sikud	सिकुड़	सिकुड़	pred_true
signals	सिगनल्स	सिगनाल्स	pred_false
cigaretton	सिगरेटों	सिगरेटन	pred_false
cigretton	सिगरेटों	सिग्रेटन	pred_false
siddhivat	सिद्धवट	सिद्धिवत	pred_false
siddhvat	सिद्धवट	सिद्धवत	pred_false
siddhwat	सिद्धवट	सिद्धवत	pred_false
sinabang	सिनाबंग	सीनबांग	pred_false
synapse	सिनेप्स	सिनाप्स	pred_false
sipah	सिपाह	सिपह	pred_false
sipaha	सिपाह	सिपहा	pred_false
sipahiyon	सिपाहियों	सिपहियों	pred_false
sipahi	सिपाही	सिपही	pred_false
sim	सिम	सिम	pred_true
simat	सिमट	सिमत	pred_false
simatataa	सिमटता	सिमटता	pred_true
simatta	सिमटता	सिमट्टा	pred_false
simtata	सिमटता	सिमटा	pred_false
simtataa	सिमटता	सिमटता	pred_true
cement	सिमटे	सीमेंट	pred_false
simate	सिमटे	सीमते	pred_false
simi	सिमी	सिमी	pred_true
simmy	सिमी	सिमी	pred_true
sims	सिम्स	सिम्स	pred_true
siyasi	सियासी	सियासी	pred_true
siyah	सियाह	सियाह	pred_true
siyaha	सियाह	सियाहा	pred_false
sirpur	सिरपुर	सिरपुर	pred_true
sivan	सिवान	सिवन	pred_false
siwan	सिवान	सिवान	pred_true
sisva	सिसवा	सिश्व	pred_false
siswa	सिसवा	सिश्व	pred_false
cil	सीआईएल	सील	pred_false
csi	सीएसआई	सीसीआई	pred_false
sikar	सीकर	सिकार	pred_false
seaten	सीटें	सीटन	pred_false
sitaram	सीताराम	सितराम	pred_false
sitaharan	सीताहरण	सितहरण	pred_false
cpm	सीपीएम	सीपीएम	pred_true
cps	सीपीएस	सीपीएस	pred_true
cbse	सीबीएसई	बिब्से	pred_false
seem	सीम	सीम	pred_true
sim	सीम	सिम	pred_false
sealed	सील्ड	सील्ड	pred_true
shield	सील्ड	शील्ड	pred_false
ccd	सीसीडी	सीसीडी	pred_true
sugamata	सुगमता	सुगमता	pred_true
sugmta	सुगमता	सुगमता	pred_true
sujan	सुजेन	सुजन	pred_false
sujen	सुजेन	सुजें	pred_false
suken	सुजेन	सुकेन	pred_false
sujain	सुजैन	सुजाइन	pred_false
sujhaati	सुझाती	सुझाती	pred_true
sujhati	सुझाती	सुझती	pred_false
sutali	सुतली	सूतली	pred_false
sutli	सुतली	सूतली	pred_false
suta	सुता	सूता	pred_false
sdueep	सुदीप	स्दुप	pred_false
sudip	सुदीप	सुदीप	pred_true
sudhaargrah	सुधारगृह	सुधारगृह	pred_true
sudhargrih	सुधारगृह	सुधारगृह	pred_true
sudhargruh	सुधारगृह	सुधारगृह	pred_true
sunaaron	सुनारों	सुनारों	pred_true
sunaron	सुनारों	सुनारों	pred_true
sunaseer	सुनासीर	सुनसीर	pred_false
sunasir	सुनासीर	सुनासीर	pred_true
suneeti	सुनीति	सुनीति	pred_true
suniti	सुनीति	सुनीति	pred_true
sunega	सुनेगा	सुनेगा	pred_true
suneyga	सुनेगा	सुनेगा	pred_true
superhit	सुपरहिट	सुपरहित	pred_false
supachy	सुपाच्य	सुपचचय	pred_false
supachya	सुपाच्य	सुपच्य	pred_false
supachye	सुपाच्य	सुपच्य	pred_false
subhaay	सुभाय	सुभाय	pred_true
subhay	सुभाय	सुभय	pred_false
surveen	सुरवीन	सूर्वीन	pred_false
survin	सुरवीन	सुर्विन	pred_false
surana	सुराणा	सुराना	pred_false
sulkhan	सुलखान	सुलखन	pred_false
suljaayi	सुलझाई	सुलजाई	pred_false
suljayi	सुलझाई	सुलझाई	pred_true
suljhai	सुलझाई	सुलझाई	pred_true
sulzai	सुलझाई	सुलझाई	pred_true
sultana	सुलताना	सुल्टाना	pred_false
sulaati	सुलाती	सुलाती	pred_true
sulati	सुलाती	सुलती	pred_false
susanskrit	सुसंस्कृत	सुसंस्कृत	pred_true
susanskrut	सुसंस्कृत	सुसंसृत	pred_false
suhagin	सुहागिन	सुहागीन	pred_false
soond	सूंड़	सूंद	pred_false
sund	सूंड़	सूंड	pred_false
suiyan	सूइयां	सुइयां	pred_false
sukhati	सूखती	सूखती	pred_true
sukhti	सूखती	सूखती	pred_true
sukhakar	सूखाकर	सुखाकर	pred_false
soochak	सूचक	सूचक	pred_true
suchak	सूचक	सूचक	pred_true
sooja	सूजा	सूजा	pred_true
suja	सूजा	सुजा	pred_false
suba	सूबा	सुबा	pred_false
sube	सूबे	सबबे	pred_false
sooraj	सूरज	सूराज	pred_false
suraj	सूरज	सुराज	pred_false
surinaam	सूरीनाम	सुरीनाम	pred_false
surinama	सूरीनाम	सुरीनामा	pred_false
suriname	सूरीनाम	सुरीनामे	pred_false
suryadev	सूर्यदेव	सुर्यदेव	pred_false
sendha	सेंधा	सेंधा	pred_true
senvai	सेंवई	सेनवाई	pred_false
sevai	सेंवई	सेवाई	pred_false
sensing	सेंसिंग	सेंसिंग	pred_true
sexual	सेक्सुअल	स्क्सुअल	pred_false
saturday	सेटरडे	सतुरदाय	pred_false
seti	सेटी	सेती	pred_false
seto	सेटो	सीटो	pred_false
seth	सेथ	सेठ	pred_false
safety	सेफ्टी	सेफेट्	pred_false
semen	सेमिन	सीमैन	pred_false
semin	सेमिन	सेमिन	pred_true
self	सेल्फ	सेल्फ	pred_true
selfie	सेल्फी	सेल्फी	pred_true
save	सेव	सावे	pred_false
sev	सेव	सेव	pred_true
sevakon	सेवकों	सेवकों	pred_true
sevkon	सेवकों	सेवकों	pred_true
samuels	सैम्युल्स	सैम्ल्स	pred_false
celery	सैलरी	सेलरी	pred_false
salary	सैलरी	सालेरी	pred_false
sakar	सॉकर	साकार	pred_false
socar	सॉकर	सोकर	pred_false
soccer	सॉकर	सॉसर	pred_false
songs	सॉन्ग्स	सोंग्स	pred_false
solicitor	सॉलिसिटर	सॉलिसिटर	pred_true
sochane	सोचने	सोचने	pred_true
sochne	सोचने	सोचने	pred_true
sonu	सोनू	सोनू	pred_true
soma	सोमा	सोमा	pred_true
spma	सोमा	स्प्मा	pred_false
somi	सोमी	सोमी	pred_true
soy	सोय	सौय	pred_false
soya	सोया	सोया	pred_true
solitaire	सोलिटेयर	सोलिटेयर	pred_true
soharai	सोहराई	सोहराई	pred_true
sohrai	सोहराई	सोहराई	pred_true
sohaval	सोहावल	सोहावल	pred_true
sohawal	सोहावल	सोहावल	pred_true
saunpane	सौंपने	सौंपने	pred_true
sonpne	सौंपने	सौंपने	pred_true
scala	स्काला	स्केला	pred_false
skala	स्काला	स्कला	pred_false
ski	स्की	स्क्की	pred_false
scootaron	स्कूटरों	स्कूटरों	pred_true
scooteron	स्कूटरों	स्कूटरों	pred_true
skootaron	स्कूटरों	स्कूतरों	pred_false
scandinavia	स्कैंडिनेविया	स्केंदिनाया	pred_false
scaining	स्कैनिंग	स्केनिंग	pred_false
scanning	स्कैनिंग	स्कैनिंग	pred_true
squash	स्क्वाश	स्क्वाश	pred_true
squash	स्क्वैश	स्क्वाश	pred_false
skhalan	स्खलन	स्खलन	pred_true
stain	स्टैन	स्टेन	pred_false
stan	स्टैन	स्टान	pred_false
stop	स्टॉप	स्टॉप	pred_true
stops	स्टॉप्स	स्टॉप्स	pred_true
stone	स्टोन	स्टोन	pred_true
straws	स्ट्रास	स्ट्रास	pred_true
stress	स्ट्रास	स्ट्रेस	pred_false
stra	स्ट्रे	स्ट्रा	pred_false
stray	स्ट्रे	स्ट्रे	pred_true
stre	स्ट्रे	स्ट्र	pred_false
strocks	स्ट्रोक्स	स्ट्रॉक्स	pred_false
strokes	स्ट्रोक्स	स्ट्रॉकस	pred_false
stan	स्तन	स्टान	pred_false
stanadhari	स्तनधारी	स्तनाधारी	pred_false
standhaari	स्तनधारी	स्तंधारी	pred_false
standhari	स्तनधारी	स्तंधारी	pred_false
sthiti	स्तिथि	स्थिति	pred_false
stithi	स्तिथि	स्तिथी	pred_false
stuti	स्तुति	स्टूटी	pred_false
sthitiyaan	स्थितियां	स्थितियां	pred_true
sthitiyan	स्थितियां	स्थितियां	pred_true
sthitiyon	स्थितियों	स्थितियों	pred_true
sthool	स्थूल	स्थूल	pred_true
sthul	स्थूल	स्थलल	pred_false
sthoolta	स्थूलता	स्थूलता	pred_true
sthulata	स्थूलता	स्थुलता	pred_false
sneakers	स्नीकर्स	स्नीकर्स	pred_true
snickers	स्नीकर्स	स्निकर्स	pred_false
snikarse	स्नीकर्स	स्निकर्स	pred_false
spear	स्पीयर	स्पीयर	pred_true
spell	स्पेल	स्पेल	pred_true
spelar	स्पेलर	स्पेलर	pred_true
speller	स्पेलर	स्पेलर	pred_true
sprint	स्प्रिट	स्प्रांट	pred_false
sprit	स्प्रिट	स्प्रित	pred_false
spray	स्प्रे	स्प्रे	pred_true
spry	स्प्रे	स्प्री	pred_false
sfoorti	स्फूर्ति	स्फूर्ति	pred_true
sfurti	स्फूर्ति	स्फूर्ति	pred_true
sphoorti	स्फूर्ति	स्फूर्ति	pred_true
slide	स्लाइड	स्लाइड	pred_true
slider	स्लाइडर	स्लाइडर	pred_true
slaaidon	स्लाइडों	स्लाइडों	pred_true
slidon	स्लाइडों	स्लीडों	pred_false
sliders	स्लाइड्स	स्लाइडर्स	pred_false
slides	स्लाइड्स	स्लाइड्स	pred_true
slice	स्लाइस	स्लाइस	pred_true
slash	स्लैश	स्लैश	pred_true
swaroopon	स्वरुपों	स्वरूपों	pred_false
swarupon	स्वरुपों	स्वरूपों	pred_false
swa	स्वा	स्वा	pred_true
swaachaalit	स्वाचालित	स्वाचालित	pred_true
swachalit	स्वाचालित	स्वचलित	pred_false
swaarthparak	स्वार्थपरक	स्वार्थपररक	pred_false
swarthparak	स्वार्थपरक	स्वर्थपरर	pred_false
swiftlate	स्विफ्टलेट	स्विफ्टल	pred_false
swiftlet	स्विफ्टलेट	स्विफ्टल	pred_false
sweekarte	स्वीकारते	स्वीकरते	pred_false
swikarte	स्वीकारते	स्वीकर्ट	pred_false
sweet	स्वीट	स्वीत	pred_false
sweep	स्वीप	स्वीप	pred_true
sweccha	स्वेच्छा	स्वेच्छा	pred_true
swecha	स्वेच्छा	स्वेच्छा	pred_true
swechha	स्वेच्छा	स्वेच्छ	pred_false
sweta	स्वेता	स्वेता	pred_true
swap	स्वैप	स्वप	pred_false
swipe	स्वैप	स्विप	pred_false
handiya	हंडिया	हंडिया	pred_true
handiyaa	हंडिया	हंडिया	pred_true
hundiya	हंडिया	हंडिया	pred_true
hakikat	हकीकत	हकीकत	pred_true
haqeeqat	हकीकत	हकीकत	pred_true
hathiya	हथिया	हथिया	pred_true
hamala	हमला	हमला	pred_true
hamla	हमला	हमला	pred_true
hamalavar	हमलावर	हमलावर	pred_true
hamlavar	हमलावर	हमलावर	pred_true
humlavar	हमलावर	हमलावर	pred_true
hamaal	हमाल	हमाल	pred_true
hamal	हमाल	हमल	pred_false
hercules	हरक्यूलिस	हर्कल्स	pred_false
hardas	हरदास	हरदास	pred_true
harpaal	हरपाल	हरपाल	pred_true
harpal	हरपाल	हरपाल	pred_true
harvansh	हरवंश	हरवांश	pred_false
haraval	हरावल	हरावल	pred_true
harawal	हरावल	हरावल	pred_true
hurricane	हरिकेन	हररिकान	pred_false
harijan	हरिजन	हरिजन	pred_true
hariyali	हरियाली	हरियाली	pred_true
harshit	हर्षित	हरशशित	pred_false
haldi	हल्दी	हल्डी	pred_false
halla	हल्ला	हल्ला	pred_true
hawamahal	हवामहल	हवामहाल	pred_false
hawalaat	हवालात	हवलात	pred_false
hawalat	हवालात	हवलत	pred_false
hasino	हसीनों	हसीनो	pred_false
hasinon	हसीनों	हसीनों	pred_true
haan	हां	हान	pred_false
han	हां	हन	pred_false
haanfte	हांफते	हाफफते	pred_false
hafate	हांफते	हफाते	pred_false
hanfte	हांफते	हैफफते	pred_false
higman	हाइमन	हिग्मान	pred_false
hymen	हाइमन	ह्मेन	pred_false
hadauti	हाड़ौती	हड़ौटी	pred_false
haani	हानी	हानी	pred_true
hani	हानी	हानी	pred_true
haarjeet	हारजीत	हार्ीत	pred_false
harjeet	हारजीत	हरजीत	pred_false
haaranaa	हारना	हारणा	pred_false
harana	हारना	हरणा	pred_false
harna	हारना	हरना	pred_false
haalchaal	हालचाल	हाचलाल	pred_false
haalchal	हालचाल	हालचाल	pred_true
halchaal	हालचाल	हलचाल	pred_false
halchal	हालचाल	हलचल	pred_false
halt	हाल्ट	हाल्ट	pred_true
hault	हाल्ट	हाल्ट	pred_true
hahakar	हाहाकार	हहकर	pred_false
hingis	हिंगिस	हिंगिस	pred_true
hindan	हिंडन	हिंदन	pred_false
hindon	हिंडन	हिंदों	pred_false
hijada	हिजड़ा	हिजड़ा	pred_true
hijda	हिजड़ा	हिजड़ा	pred_true
hijbul	हिजबुल	हिजबूल	pred_false
hippo	हिप्पो	हिप्पो	pred_true
hippopotamus	हिप्पोपोटेमस	हिप्पोपम	pred_false
himali	हिमाली	हिमली	pred_false
hilane	हिलने	हिलाने	pred_false
hilne	हिलने	हिलने	pred_true
hisham	हिशाम	हिशम	pred_false
heeraganj	हीरागंज	हीरगगंज	pred_false
hiraganj	हीरागंज	हिरागंज	pred_false
heroes	हीरोज	हेरोज	pred_false
heros	हीरोज	हीरोस	pred_false
hui	हुईं	हुई	pred_false
huin	हुईं	हुइन	pred_false
hooper	हूपर	हूपर	pred_true
huppar	हूपर	हुप्पर	pred_false
hupper	हूपर	हप्पर	pred_false
hegde	हेगडे	हेगडड	pred_false
hemvati	हेमवती	हेमवाती	pred_false
hemwati	हेमवती	हेमवाती	pred_false
help	हेल्प	हेल्प	pred_true
helper	हेल्पर	हेलर	pred_false
haito	हैतो	हैतो	pred_true
hairam	हैरम	हैराम	pred_false
harem	हैरम	हरेम	pred_false
herald	हैराल्ड	हेराल्ड	pred_false
haive	हैव	हाइव	pred_false
have	हैव	हेव	pred_false
hong	हॉन्ग	हांग	pred_false
half	हॉफ	हाफ	pred_false
hoaf	हॉफ	होफ	pred_false
hounga	होऊंगा	हाउगा	pred_false
holding	होल्डिंग	हाल्डिंग	pred_false
hoshangabaad	होशंगाबाद	होशनगाबाद	pred_false
hoshangabad	होशंगाबाद	होशागाबाद	pred_false
hostes	होस्टेस	होस्ट	pred_false
hostess	होस्टेस	होस्टेस	pred_true
